churn,idade,sexo,profissao,regiao_residencia,risco,n_dias_como_associado,num_transacoes,num_transacoes_online,num_transacoes_presenciais,valor_min_transacao,valor_medio_transacao,valor_max_transacao,n_dias_desde_ultima_transacao,n_dias_desde_primeira_transacao,n_dias_ate_primeira_transacao,num_atendimentos,n_dias_desde_ultimo_atendimento,n_dias_desde_primeiro_atendimento
0,38,1,7,0,1,1031,20,11,9,4,210.2,680,17,196,835,,,
0,42,1,2,0,0,1029,14,6,8,16,128.21428571428572,520,31,203,826,,,
0,36,0,1,0,1,1028,9,6,3,19,213.55555555555554,469,17,177,851,,,
0,39,0,7,2,0,1026,14,8,6,5,169.5,365,6,203,823,,,
0,34,0,6,1,0,1026,14,5,9,6,127.5,328,6,181,845,,,
0,38,1,6,1,1,1025,14,7,7,21,213.71428571428572,445,8,180,845,,,
0,33,1,2,4,1,1025,12,5,7,28,182.83333333333334,453,9,202,823,1.0,130.0,130.0
0,34,1,2,1,0,1025,22,11,11,13,176.5909090909091,680,9,187,838,1.0,150.0,150.0
0,33,1,7,0,0,1024,12,8,4,2,119.33333333333333,390,15,200,824,,,
0,41,0,2,1,0,1024,10,7,3,43,203.9,382,15,160,864,,,
0,41,0,2,0,1,1024,22,13,9,5,132.36363636363637,385,3,200,824,,,
0,40,0,3,0,1,1023,19,9,10,12,159.26315789473685,490,1,190,833,1.0,131.0,131.0
0,40,1,7,2,0,1023,18,3,15,4,189.22222222222223,686,23,176,847,,,
0,31,1,2,1,3,1022,20,9,11,23,149.25,343,18,207,815,,,
0,33,0,3,1,0,1022,15,8,7,6,172.53333333333333,363,35,196,826,1.0,9.0,9.0
0,38,1,8,1,0,1021,17,11,6,9,147.11764705882354,478,24,209,812,,,
0,42,1,3,3,1,1020,11,5,6,49,148.1818181818182,374,37,188,832,,,
0,32,1,8,3,1,1019,14,8,6,11,179.0,602,9,165,854,2.0,16.0,349.0
1,33,1,6,3,1,1018,8,3,5,21,213.375,796,7,209,809,1.0,107.0,107.0
0,35,0,3,0,1,1018,13,4,9,24,146.76923076923077,524,23,205,813,1.0,41.0,41.0
1,35,1,1,1,1,1017,8,5,3,10,182.25,756,24,161,856,2.0,37.0,265.0
1,42,1,5,0,3,1017,11,3,8,4,206.63636363636363,846,34,139,878,1.0,290.0,290.0
0,39,0,3,1,0,1016,20,7,13,7,164.45,408,1,199,817,,,
0,38,1,3,3,1,1016,12,4,8,16,177.08333333333334,547,8,208,808,,,
0,36,1,2,2,0,1014,14,7,7,7,130.5,542,5,196,818,,,
0,34,1,1,0,1,1013,10,8,2,5,149.3,467,10,200,813,,,
0,34,1,7,1,0,1012,12,9,3,7,183.83333333333334,450,55,191,821,,,
1,32,1,2,1,2,1012,8,3,5,5,120.25,200,15,202,810,,,
0,38,0,9,0,1,1011,17,9,8,15,209.1764705882353,616,20,190,821,1.0,168.0,168.0
0,30,0,3,4,1,1011,9,4,5,4,152.33333333333334,444,3,190,821,,,
0,32,1,7,0,1,1011,16,7,9,4,139.5625,309,15,187,824,,,
0,41,1,7,0,1,1008,16,7,9,16,187.8125,719,3,186,822,1.0,4.0,4.0
1,28,1,4,1,2,1008,7,4,3,27,308.14285714285717,840,47,171,837,1.0,12.0,12.0
0,33,1,5,3,1,1005,16,10,6,38,139.375,485,14,193,812,,,
0,35,1,4,3,0,1005,21,9,12,2,209.38095238095238,569,6,205,800,,,
0,29,0,6,2,0,1005,12,7,5,42,198.58333333333334,402,16,207,798,,,
0,37,0,3,1,0,1004,16,13,3,1,157.5625,440,3,204,800,,,
0,38,1,8,1,0,1004,17,7,10,5,213.88235294117646,646,15,201,803,,,
0,32,0,4,2,0,1002,16,11,5,5,138.25,438,3,203,799,1.0,18.0,18.0
0,31,1,7,1,0,1002,13,4,9,5,152.92307692307693,433,16,193,809,,,
0,34,1,8,3,0,1001,11,6,5,7,203.27272727272728,395,45,175,826,,,
0,33,1,7,0,0,1001,12,5,7,4,240.66666666666666,658,2,205,796,,,
0,33,1,3,1,0,1001,18,8,10,9,200.94444444444446,486,11,201,800,1.0,353.0,353.0
0,33,1,2,0,1,997,19,11,8,18,224.6315789473684,617,8,152,845,,,
0,44,1,8,0,1,996,32,15,17,11,571.28125,12652,1,199,797,1.0,17.0,17.0
0,32,0,7,4,1,996,16,10,6,12,195.25,602,15,209,787,,,
0,36,0,8,0,1,996,8,4,4,58,593.75,3511,33,207,789,,,
0,39,0,2,3,0,993,21,9,12,7,177.76190476190476,440,4,193,800,,,
0,27,0,2,3,0,992,16,6,10,12,165.375,485,11,198,794,,,
0,32,1,8,0,1,992,17,7,10,6,141.2941176470588,452,2,201,791,,,
0,32,0,5,3,2,992,14,9,5,66,203.57142857142858,589,5,182,810,,,
0,33,0,5,1,0,989,19,6,13,7,193.52631578947367,430,5,187,802,,,
0,38,0,1,4,0,988,19,7,12,9,211.42105263157896,580,1,175,813,1.0,89.0,89.0
0,34,1,7,3,2,987,11,2,9,7,215.45454545454547,706,10,195,792,,,
0,27,0,5,3,1,986,12,7,5,19,118.41666666666667,253,12,190,796,,,
1,35,1,1,1,2,985,9,5,4,63,328.8888888888889,810,9,167,818,1.0,199.0,199.0
0,40,1,8,1,0,982,16,8,8,10,139.75,432,6,203,779,,,
0,22,0,8,1,0,980,10,6,4,5,171.9,489,9,201,779,,,
1,31,1,4,4,0,980,15,7,8,9,204.33333333333334,736,2,203,777,2.0,6.0,36.0
0,29,1,3,0,0,980,14,8,6,15,671.0,7643,34,175,805,,,
0,31,0,5,0,0,980,9,5,4,4,115.88888888888889,420,17,200,780,,,
1,39,1,2,4,0,979,19,11,8,9,328.63157894736844,891,23,198,781,3.0,30.0,188.0
0,34,1,3,2,1,978,14,9,5,20,175.85714285714286,395,6,199,779,,,
0,39,1,7,1,0,977,30,12,18,6,139.06666666666666,552,3,203,774,,,
1,27,1,8,1,2,977,7,5,2,18,182.28571428571428,408,26,178,799,1.0,11.0,11.0
0,33,1,7,2,0,975,14,2,12,21,140.35714285714286,454,6,201,774,,,
0,38,0,5,1,0,975,12,7,5,7,183.83333333333334,629,40,172,803,,,
0,35,1,2,3,1,975,12,6,6,28,1152.25,11470,20,195,780,,,
0,39,0,2,0,1,974,18,11,7,3,133.77777777777777,415,12,205,769,1.0,353.0,353.0
0,33,1,5,4,0,974,15,8,7,22,115.06666666666666,304,35,188,786,,,
0,46,0,6,1,0,974,18,8,10,1,204.61111111111111,519,2,183,791,,,
0,26,0,2,1,0,969,17,3,14,15,174.64705882352942,541,36,186,783,1.0,12.0,12.0
1,41,1,6,1,2,969,7,2,5,11,224.57142857142858,428,7,155,814,1.0,43.0,43.0
0,42,1,3,1,0,968,12,4,8,8,176.16666666666666,541,16,198,770,,,
0,32,0,2,1,1,967,18,11,7,12,156.38888888888889,438,16,197,770,,,
0,34,1,2,0,0,966,13,6,7,8,173.30769230769232,496,53,176,790,,,
0,36,1,5,2,0,966,17,10,7,3,284.5882352941176,2891,16,206,760,,,
0,39,0,1,2,0,964,11,4,7,15,157.54545454545453,426,5,165,799,,,
0,34,1,7,1,0,961,12,6,6,11,142.91666666666666,244,26,206,755,2.0,10.0,27.0
0,38,0,7,2,1,960,9,3,6,34,123.11111111111111,241,13,209,751,,,
0,30,1,7,1,0,958,28,15,13,1,165.42857142857142,730,14,207,751,1.0,30.0,30.0
0,38,0,2,4,1,957,13,4,9,9,139.3846153846154,438,32,187,770,,,
0,29,1,6,2,1,957,18,6,12,1,847.0,12435,18,199,758,,,
0,37,0,1,1,0,956,17,9,8,9,139.8235294117647,419,16,194,762,1.0,259.0,259.0
0,28,0,7,0,1,956,14,7,7,8,169.85714285714286,717,5,190,766,,,
0,42,1,7,3,0,956,14,4,10,3,123.21428571428571,530,35,199,757,,,
0,34,0,1,0,0,955,15,6,9,7,187.8,470,2,160,795,,,
0,35,1,2,0,0,955,8,4,4,2,87.875,173,5,165,790,,,
0,34,0,1,1,0,955,12,8,4,19,144.16666666666666,362,8,194,761,,,
0,34,1,3,1,0,953,12,7,5,1,550.8333333333334,4732,14,173,780,,,
0,45,1,9,0,0,953,17,12,5,24,138.76470588235293,335,19,203,750,1.0,158.0,158.0
0,29,0,6,0,0,952,10,8,2,36,166.0,395,1,209,743,,,
0,36,0,7,4,0,952,19,11,8,12,129.0,481,4,207,745,,,
0,35,1,8,1,1,951,9,4,5,15,208.22222222222223,512,16,204,747,,,
0,40,0,2,2,2,951,14,7,7,11,239.14285714285714,510,8,207,744,,,
0,41,1,1,1,0,951,11,4,7,33,143.36363636363637,376,12,193,758,,,
1,46,1,3,1,2,950,11,3,8,32,227.45454545454547,805,1,164,786,1.0,28.0,28.0
0,38,0,5,0,0,949,14,8,6,3,153.21428571428572,547,13,203,746,,,
0,40,0,2,4,1,949,11,4,7,6,213.72727272727272,420,2,199,750,1.0,159.0,159.0
0,32,1,8,0,1,949,21,10,11,1,227.8095238095238,436,14,206,743,,,
0,48,0,4,1,0,947,14,9,5,28,221.14285714285714,394,15,207,740,,,
0,43,0,3,3,0,944,18,9,9,17,204.5,740,2,203,741,,,
0,21,0,2,2,2,943,14,7,7,45,182.21428571428572,403,12,209,734,,,
0,39,1,4,1,0,943,13,7,6,4,167.69230769230768,634,1,200,743,,,
0,27,0,2,4,0,942,20,9,11,10,128.1,493,1,202,740,1.0,203.0,203.0
0,29,1,8,1,0,941,13,8,5,17,165.92307692307693,371,4,197,744,,,
0,33,0,2,2,1,941,21,13,8,2,129.04761904761904,418,10,206,735,,,
0,38,0,3,1,0,941,12,4,8,2,771.8333333333334,7521,4,189,752,,,
0,38,1,2,3,2,940,14,9,5,44,225.35714285714286,619,1,204,736,1.0,162.0,162.0
0,38,0,2,0,0,940,16,2,14,16,175.6875,517,12,199,741,,,
0,31,1,4,1,0,939,34,18,16,4,187.0,520,1,208,731,1.0,131.0,131.0
0,28,1,3,0,1,938,10,5,5,14,201.7,525,20,192,746,1.0,32.0,32.0
0,39,1,3,1,0,938,10,5,5,33,174.4,369,23,188,750,1.0,108.0,108.0
0,31,0,7,1,0,938,21,9,12,21,716.2380952380952,11292,2,189,749,,,
0,37,0,7,2,0,937,11,6,5,26,186.0,677,30,206,731,1.0,159.0,159.0
1,31,1,3,0,3,937,8,3,5,4,124.25,411,58,202,735,1.0,8.0,8.0
0,40,1,8,4,1,936,9,2,7,20,196.55555555555554,482,39,147,789,,,
0,33,0,9,0,1,935,32,19,13,3,146.21875,458,3,200,735,,,
0,27,0,2,1,0,935,27,15,12,4,472.8888888888889,8912,1,205,730,1.0,231.0,231.0
0,31,0,7,2,0,934,15,9,6,2,207.06666666666666,615,12,184,750,,,
0,36,1,7,1,0,933,13,7,6,14,136.76923076923077,311,23,209,724,1.0,140.0,140.0
1,29,0,3,2,0,933,11,4,7,16,241.0909090909091,670,32,206,727,1.0,106.0,106.0
1,33,1,3,0,2,933,5,2,3,10,260.6,727,35,206,727,1.0,6.0,6.0
1,31,1,8,3,1,931,7,2,5,5,255.0,852,16,173,758,1.0,318.0,318.0
0,34,1,2,0,1,929,21,11,10,10,805.8095238095239,13943,1,202,727,,,
0,37,1,1,3,1,929,13,5,8,11,174.30769230769232,593,22,183,746,,,
0,30,1,3,4,1,928,16,8,8,35,181.25,679,7,196,732,1.0,294.0,294.0
0,34,0,2,0,0,927,9,3,6,2,237.77777777777777,668,1,198,729,,,
0,36,1,2,1,0,926,19,8,11,7,162.10526315789474,548,1,188,738,1.0,69.0,69.0
0,43,1,5,1,0,924,16,10,6,7,855.5,12165,3,194,730,1.0,202.0,202.0
0,30,1,3,2,2,924,14,5,9,11,142.57142857142858,400,6,199,725,,,
0,43,1,8,2,1,922,11,5,6,2,217.54545454545453,587,7,201,721,,,
0,27,0,8,1,0,922,31,13,18,14,200.38709677419354,698,4,206,716,1.0,168.0,168.0
0,41,0,6,3,2,921,16,6,10,4,115.5625,414,5,206,715,,,
0,40,1,3,1,0,919,7,3,4,47,216.14285714285714,410,41,180,739,1.0,37.0,37.0
0,38,1,1,4,0,918,13,9,4,17,185.69230769230768,442,27,207,711,,,
0,38,1,5,1,0,917,14,8,6,6,163.71428571428572,499,11,208,709,1.0,16.0,16.0
0,30,0,7,0,1,916,15,7,8,14,126.33333333333333,328,21,207,709,,,
0,41,0,1,0,1,916,17,10,7,4,162.47058823529412,462,21,196,720,,,
0,33,1,7,1,0,916,13,7,6,5,128.69230769230768,443,5,197,719,,,
0,37,1,6,2,1,914,11,3,8,7,154.36363636363637,412,8,203,711,,,
1,36,1,2,1,2,913,10,4,6,8,187.9,913,7,208,705,1.0,38.0,38.0
0,31,0,4,2,0,912,9,5,4,23,204.22222222222223,441,42,197,715,2.0,101.0,155.0
0,27,0,2,0,1,911,14,7,7,9,111.28571428571429,310,21,209,702,,,
0,31,1,1,0,1,910,18,10,8,5,156.61111111111111,435,14,209,701,2.0,64.0,231.0
0,32,1,9,1,0,910,10,5,5,6,166.2,431,3,207,703,1.0,62.0,62.0
0,33,0,7,0,0,908,18,11,7,38,173.22222222222223,540,14,207,701,,,
0,45,0,8,0,0,907,17,10,7,8,178.8235294117647,428,6,190,717,,,
0,40,1,3,4,0,906,20,8,12,2,905.0,14789,1,187,719,,,
0,48,1,7,1,1,905,21,11,10,2,139.85714285714286,381,8,199,706,,,
0,37,0,4,0,1,903,14,5,9,4,139.35714285714286,374,11,203,700,,,
0,49,1,3,1,0,903,15,9,6,2,138.13333333333333,450,5,206,697,,,
0,28,1,8,0,1,902,8,4,4,21,133.75,310,9,151,751,,,
0,31,0,7,1,0,902,11,7,4,50,1513.4545454545455,14772,35,198,704,,,
0,38,0,7,0,1,901,33,16,17,4,406.45454545454544,7572,2,208,693,1.0,76.0,76.0
0,30,0,8,4,1,901,17,4,13,26,155.35294117647058,515,5,194,707,,,
0,28,0,3,1,0,901,10,3,7,16,232.1,543,5,205,696,,,
0,28,1,7,4,0,900,11,6,5,21,169.27272727272728,390,1,208,692,,,
0,36,0,8,1,0,899,13,7,6,34,244.69230769230768,593,10,207,692,1.0,93.0,93.0
0,39,0,5,3,1,899,16,8,8,1,164.5625,606,22,202,697,1.0,43.0,43.0
0,29,1,3,1,0,897,21,12,9,10,139.66666666666666,386,4,200,697,,,
0,39,0,7,0,1,897,20,14,6,13,237.3,522,1,201,696,,,
0,32,1,7,0,1,895,12,7,5,15,216.08333333333334,511,29,189,706,,,
0,41,1,8,1,0,894,25,13,12,21,179.2,499,1,209,685,,,
0,37,0,7,2,1,891,19,10,9,2,179.21052631578948,592,5,200,691,,,
0,44,0,2,3,0,891,22,14,8,17,323.3181818181818,3369,39,201,690,,,
0,38,0,8,1,0,890,15,7,8,13,164.26666666666668,420,17,195,695,1.0,157.0,157.0
0,35,0,6,0,1,890,19,10,9,25,165.78947368421052,607,3,198,692,,,
0,39,1,7,4,1,890,21,10,11,10,150.8095238095238,317,7,197,693,2.0,36.0,318.0
0,34,1,7,2,0,890,13,7,6,10,206.23076923076923,556,10,209,681,,,
0,31,0,4,0,0,889,22,11,11,1,102.45454545454545,334,3,201,688,1.0,91.0,91.0
0,35,0,7,0,1,889,20,14,6,9,217.05,564,4,207,682,1.0,14.0,14.0
0,37,1,7,1,0,887,13,4,9,39,333.15384615384613,1899,15,173,714,,,
0,33,0,7,4,3,887,8,5,3,17,179.0,413,31,198,689,,,
0,32,1,6,0,1,887,16,8,8,2,865.1875,11696,27,206,681,1.0,132.0,132.0
0,33,0,3,3,2,886,20,11,9,3,130.15,423,1,197,689,,,
0,45,0,1,0,1,885,13,7,6,14,231.23076923076923,492,14,208,677,1.0,45.0,45.0
1,34,1,2,1,1,885,11,6,5,14,316.1818181818182,896,21,180,705,1.0,260.0,260.0
1,33,1,7,1,2,883,9,4,5,16,172.66666666666666,406,13,125,758,1.0,32.0,32.0
0,43,1,2,4,1,881,13,5,8,5,213.46153846153845,520,3,208,673,,,
0,37,0,3,1,3,880,8,5,3,8,131.5,511,8,192,688,,,
0,37,1,3,2,0,880,18,7,11,4,144.38888888888889,485,3,207,673,1.0,10.0,10.0
0,25,1,8,3,0,878,7,3,4,28,143.57142857142858,205,17,174,704,,,
0,45,0,8,1,0,878,27,14,13,23,218.85185185185185,451,17,199,679,1.0,172.0,172.0
0,45,1,7,0,1,877,34,17,17,7,255.0,2437,8,209,668,1.0,201.0,201.0
0,28,0,5,4,0,875,15,6,9,46,139.4,301,16,186,689,,,
0,31,1,7,0,0,875,19,7,12,10,152.26315789473685,457,3,182,693,,,
0,38,0,9,2,2,873,11,7,4,3,139.1818181818182,372,7,179,694,,,
0,42,1,2,2,0,873,18,9,9,14,186.27777777777777,387,11,209,664,,,
0,35,1,3,1,1,872,7,6,1,4,141.57142857142858,221,15,207,665,,,
0,44,1,2,3,1,871,12,1,11,25,130.83333333333334,302,17,207,664,,,
0,40,0,3,0,1,871,15,6,9,32,208.73333333333332,452,13,203,668,1.0,12.0,12.0
0,44,0,5,2,0,871,13,8,5,1,190.6153846153846,446,13,207,664,,,
0,34,1,5,0,1,870,15,5,10,18,191.73333333333332,515,25,206,664,1.0,204.0,204.0
0,28,0,2,4,0,869,8,5,3,78,147.125,330,22,192,677,,,
0,37,0,5,2,1,868,11,6,5,40,124.81818181818181,286,3,179,689,1.0,50.0,50.0
0,32,0,3,3,0,867,14,8,6,19,144.14285714285714,361,1,187,680,,,
0,27,0,8,3,3,867,9,2,7,22,101.11111111111111,262,7,171,696,,,
0,39,1,3,0,2,867,8,5,3,12,181.75,424,3,198,669,,,
0,34,0,7,0,0,867,15,9,6,8,173.6,500,8,194,673,1.0,265.0,265.0
0,40,1,7,1,0,867,14,7,7,33,239.92857142857142,363,9,206,661,2.0,98.0,261.0
0,37,0,7,2,1,866,17,8,9,6,184.7058823529412,378,24,168,698,,,
0,34,0,4,1,0,866,10,4,6,42,163.7,245,2,198,668,,,
0,38,0,8,0,1,866,17,12,5,2,170.05882352941177,594,17,205,661,2.0,62.0,181.0
0,43,1,2,1,0,865,17,11,6,19,154.1764705882353,778,14,184,681,,,
1,30,1,2,1,2,865,11,4,7,9,241.8181818181818,854,4,207,658,2.0,4.0,36.0
0,32,0,3,0,1,863,15,10,5,2,169.53333333333333,506,11,190,673,,,
1,31,1,6,1,2,862,8,6,2,10,247.875,749,6,117,745,,,
0,45,1,6,2,1,861,18,10,8,2,173.55555555555554,563,9,189,672,,,
0,39,1,1,0,1,861,9,6,3,25,219.44444444444446,505,30,177,684,,,
0,35,1,1,1,0,860,15,9,6,30,134.33333333333334,379,19,196,664,,,
0,34,0,7,1,0,860,15,7,8,10,168.0,616,14,209,651,,,
0,35,1,2,1,0,860,11,4,7,19,205.72727272727272,440,15,198,662,,,
0,33,0,8,1,0,859,8,3,5,4,92.875,419,17,193,666,,,
0,34,1,2,4,0,859,15,6,9,3,137.33333333333334,540,2,194,665,,,
0,28,1,3,1,0,859,12,9,3,28,161.75,494,25,196,663,,,
0,37,0,6,1,0,858,12,5,7,11,157.83333333333334,382,14,188,670,,,
0,35,1,2,0,1,858,18,6,12,1,135.11111111111111,302,4,178,680,1.0,128.0,128.0
0,26,1,2,1,0,856,19,13,6,2,202.8421052631579,477,25,199,657,,,
1,33,1,8,1,2,855,8,6,2,7,240.875,767,19,189,666,1.0,3.0,3.0
0,38,0,2,0,3,854,18,12,6,1,173.66666666666666,550,19,187,667,,,
0,32,1,6,4,1,851,15,6,9,17,150.66666666666666,417,8,192,659,,,
0,36,0,2,1,0,851,15,3,12,12,139.73333333333332,553,18,205,646,,,
0,34,0,8,2,1,851,13,4,9,4,183.84615384615384,563,1,179,672,,,
0,40,1,3,0,0,850,17,10,7,3,199.0,628,2,200,650,,,
0,33,0,8,2,1,849,10,4,6,17,171.1,449,8,201,648,,,
0,35,1,7,1,0,849,17,7,10,29,221.2941176470588,651,18,195,654,,,
0,40,0,5,3,1,849,20,10,10,3,374.45,4796,3,190,659,,,
0,32,0,3,1,0,849,23,11,12,20,190.43478260869566,511,2,192,657,,,
0,37,1,2,1,0,848,16,5,11,52,238.4375,512,8,204,644,,,
0,33,0,5,4,0,848,14,9,5,13,195.07142857142858,523,1,207,641,,,
0,38,1,7,4,3,846,15,4,11,27,199.0,564,2,181,665,,,
0,33,0,7,2,2,846,15,8,7,28,1041.9333333333334,12425,4,208,638,,,
0,44,1,2,3,2,844,7,4,3,11,117.28571428571429,261,39,195,649,1.0,112.0,112.0
0,34,0,4,1,0,843,10,2,8,21,200.1,571,9,192,651,,,
1,36,1,1,1,2,843,11,7,4,30,246.0,903,23,183,660,1.0,38.0,38.0
0,31,0,6,4,1,841,34,15,19,4,127.47058823529412,419,6,208,633,,,
0,35,1,5,1,1,841,18,8,10,8,175.83333333333334,650,7,200,641,,,
0,31,0,8,2,1,840,11,6,5,7,185.9090909090909,468,21,153,687,,,
0,42,0,1,2,0,839,16,8,8,5,209.125,799,18,206,633,,,
0,42,1,8,4,1,839,16,8,8,3,213.625,762,3,205,634,,,
0,36,0,7,4,0,838,20,11,9,1,168.9,457,24,209,629,,,
0,47,1,7,1,2,837,14,8,6,32,147.0,514,1,191,646,,,
0,41,1,7,1,1,837,22,14,8,21,134.72727272727272,428,9,206,631,,,
0,37,0,7,1,0,837,18,8,10,30,149.61111111111111,391,6,201,636,2.0,105.0,199.0
0,38,1,5,4,0,836,13,6,7,4,126.07692307692308,324,9,192,644,,,
0,36,0,7,0,1,836,21,7,14,23,163.1904761904762,366,1,200,636,,,
0,34,1,7,2,0,836,12,7,5,5,209.66666666666666,451,22,159,677,,,
0,38,0,2,2,1,835,23,12,11,1,141.56521739130434,383,12,206,629,1.0,89.0,89.0
0,32,0,2,0,1,833,9,5,4,12,169.33333333333334,366,32,165,668,1.0,118.0,118.0
0,36,1,2,0,1,832,21,11,10,16,181.85714285714286,660,3,202,630,1.0,36.0,36.0
0,47,1,3,2,0,831,18,9,9,6,174.44444444444446,510,3,198,633,,,
0,46,0,2,3,1,831,16,7,9,3,732.625,8249,12,203,628,,,
0,38,1,8,1,0,831,12,10,2,25,130.66666666666666,270,12,205,626,1.0,1.0,1.0
0,38,0,7,1,0,828,11,8,3,10,127.0,513,19,177,651,1.0,97.0,97.0
0,50,0,7,0,1,828,12,5,7,28,120.75,297,18,199,629,,,
0,34,0,3,4,1,827,23,9,14,2,212.69565217391303,500,5,194,633,,,
0,23,0,2,0,1,827,6,4,2,7,164.33333333333334,419,3,189,638,1.0,349.0,349.0
0,32,0,2,1,0,827,19,10,9,4,147.89473684210526,368,6,206,621,,,
0,38,1,1,0,0,826,19,5,14,4,127.57894736842105,315,15,208,618,,,
0,39,1,8,1,1,825,16,11,5,23,207.6875,590,9,202,623,1.0,2.0,2.0
0,37,1,2,0,1,825,12,8,4,21,172.0,359,20,198,627,,,
0,33,0,7,3,1,825,16,10,6,8,93.125,210,7,208,617,,,
1,38,1,4,1,2,824,8,3,5,29,263.125,909,10,156,668,3.0,88.0,320.0
0,42,1,8,1,1,823,10,4,6,12,127.8,355,10,190,633,,,
0,31,0,8,0,0,823,11,7,4,8,94.45454545454545,176,45,150,673,,,
0,28,0,6,0,1,822,18,5,13,8,245.5,661,8,205,617,1.0,186.0,186.0
0,32,0,4,3,1,822,17,11,6,12,167.23529411764707,370,16,193,629,,,
0,28,0,5,0,0,822,34,23,11,4,131.02941176470588,689,11,208,614,,,
1,39,1,7,1,2,822,9,6,3,12,247.33333333333334,883,3,186,636,2.0,77.0,320.0
0,34,0,9,1,0,821,15,6,9,12,151.86666666666667,385,2,199,622,,,
0,42,0,3,1,1,820,9,4,5,7,242.66666666666666,442,6,201,619,,,
0,34,1,5,3,0,819,14,4,10,2,147.21428571428572,640,7,192,627,,,
0,43,1,2,1,0,819,14,5,9,2,123.42857142857143,545,32,189,630,,,
0,26,1,3,3,1,819,14,4,10,2,156.42857142857142,519,1,205,614,1.0,150.0,150.0
0,32,0,2,1,0,818,15,11,4,46,196.93333333333334,376,29,193,625,,,
0,32,0,2,0,1,818,6,3,3,15,193.66666666666666,543,63,204,614,1.0,261.0,261.0
0,38,1,2,2,0,817,12,8,4,8,178.91666666666666,448,5,189,628,,,
1,33,1,8,1,2,817,8,3,5,20,254.75,877,8,209,608,1.0,318.0,318.0
0,31,1,5,2,1,814,13,7,6,3,168.23076923076923,478,14,172,642,,,
0,45,0,5,1,0,814,11,7,4,2,195.63636363636363,539,36,198,616,1.0,197.0,197.0
0,39,0,2,1,0,812,13,9,4,71,1279.8461538461538,14131,1,200,612,,,
0,29,0,8,0,1,809,13,7,6,8,169.69230769230768,618,3,201,608,1.0,349.0,349.0
0,45,1,7,2,1,808,10,6,4,5,560.9,4548,2,169,639,,,
0,37,1,3,1,1,807,17,11,6,10,149.0,660,15,208,599,,,
0,36,1,5,1,0,807,17,7,10,2,137.52941176470588,416,3,198,609,,,
0,36,0,7,1,0,806,16,6,10,4,222.5625,609,15,203,603,,,
0,36,1,1,1,0,806,21,12,9,15,162.66666666666666,532,5,208,598,,,
0,35,0,9,3,1,806,20,12,8,6,177.1,442,4,208,598,,,
0,36,1,6,1,0,805,13,4,9,17,159.46153846153845,330,6,201,604,,,
0,32,0,6,2,0,805,21,13,8,3,197.76190476190476,701,28,206,599,1.0,168.0,168.0
0,27,0,7,1,3,804,22,11,11,3,180.22727272727272,499,4,204,600,,,
0,34,1,3,0,1,802,12,3,9,9,130.25,267,22,202,600,,,
0,38,0,3,3,1,802,14,6,8,26,1077.7142857142858,13084,38,195,607,,,
0,29,0,5,0,0,801,11,3,8,8,122.0,247,20,200,601,,,
0,37,1,5,3,3,800,10,6,4,42,227.2,475,38,193,607,,,
0,33,0,8,3,0,800,22,12,10,4,180.36363636363637,518,8,209,591,,,
0,25,0,9,0,1,798,9,6,3,14,109.44444444444444,227,64,184,614,,,
0,38,0,1,4,0,795,17,5,12,14,133.94117647058823,476,22,184,611,,,
1,33,1,2,0,3,795,8,4,4,51,322.125,744,7,208,587,2.0,109.0,230.0
0,31,1,8,2,0,794,16,9,7,21,178.375,524,7,192,602,,,
0,40,0,8,1,0,794,14,5,9,58,164.92857142857142,319,53,207,587,,,
0,37,1,9,1,2,793,14,9,5,9,204.78571428571428,528,4,198,595,,,
0,29,0,2,2,1,792,13,7,6,28,145.92307692307693,506,32,203,589,1.0,264.0,264.0
0,38,1,7,3,1,792,19,13,6,13,150.3684210526316,570,4,209,583,,,
0,29,1,2,0,0,792,16,8,8,39,144.4375,362,7,199,593,,,
0,41,1,3,3,0,791,21,12,9,13,202.85714285714286,530,8,208,583,,,
0,35,0,4,3,2,790,11,6,5,8,1188.2727272727273,11564,6,193,597,,,
0,34,1,5,0,0,790,13,5,8,1,158.92307692307693,439,32,209,581,,,
0,39,1,1,0,0,790,12,4,8,4,102.08333333333333,346,5,195,595,,,
0,27,0,2,3,1,789,29,11,18,3,160.44827586206895,552,4,202,587,,,
0,26,1,7,1,0,788,16,9,7,9,162.1875,514,29,201,587,,,
0,31,0,7,1,0,788,16,6,10,10,141.75,609,9,208,580,,,
0,43,1,3,4,0,786,13,6,7,17,155.84615384615384,399,31,206,580,2.0,27.0,230.0
0,37,0,4,2,0,785,18,8,10,2,325.6666666666667,3542,3,205,580,,,
0,30,0,2,1,0,785,24,11,13,8,164.875,545,27,198,587,,,
1,37,1,7,1,2,783,7,3,4,10,272.2857142857143,778,3,199,584,1.0,5.0,5.0
0,43,0,8,2,0,782,15,9,6,25,220.8,603,12,209,573,1.0,44.0,44.0
1,36,1,9,1,2,782,10,6,4,32,263.4,756,18,197,585,1.0,290.0,290.0
0,34,0,2,0,1,781,16,7,9,16,187.25,417,2,163,618,,,
0,42,1,2,1,0,780,16,11,5,7,238.875,627,14,207,573,,,
0,37,1,3,1,1,780,14,7,7,3,139.57142857142858,438,11,202,578,,,
0,31,1,9,0,1,778,8,5,3,18,159.5,328,52,206,572,,,
0,33,1,4,2,0,778,12,2,10,9,174.33333333333334,514,18,185,593,,,
0,45,0,2,0,1,775,22,15,7,12,190.0,672,6,196,579,1.0,10.0,10.0
0,34,0,6,1,1,774,12,6,6,7,293.1666666666667,2154,15,200,574,,,
1,24,1,2,0,3,773,7,3,4,5,193.57142857142858,359,46,200,573,1.0,46.0,46.0
0,40,1,2,4,1,771,18,13,5,1,176.22222222222223,454,12,194,577,1.0,98.0,98.0
1,33,1,2,0,3,771,7,2,5,13,174.71428571428572,818,54,162,609,,,
0,36,0,8,4,1,769,14,5,9,25,167.42857142857142,388,8,184,585,,,
0,40,1,7,0,0,769,14,8,6,8,152.28571428571428,616,11,183,586,,,
0,42,0,7,1,0,765,7,6,1,5,81.0,348,8,189,576,,,
1,26,1,3,1,2,764,8,3,5,13,237.0,919,7,190,574,2.0,168.0,198.0
0,37,0,6,2,0,764,7,5,2,5,245.14285714285714,404,16,180,584,,,
0,43,0,4,0,1,763,19,9,10,2,140.42105263157896,380,22,209,554,,,
0,29,1,3,2,0,763,13,3,10,9,183.84615384615384,571,4,201,562,,,
0,48,1,7,3,2,762,37,17,20,5,173.6216216216216,526,4,201,561,2.0,88.0,174.0
0,24,1,8,2,0,761,16,12,4,26,220.75,437,10,208,553,,,
0,37,1,7,1,0,761,17,9,8,29,194.0,521,4,206,555,,,
0,50,0,1,1,0,761,23,9,14,4,157.1304347826087,654,9,207,554,,,
0,32,1,3,0,1,759,11,6,5,5,188.45454545454547,503,29,203,556,,,
0,34,0,3,4,3,759,11,6,5,32,199.72727272727272,392,8,170,589,1.0,141.0,141.0
0,36,0,8,0,1,759,11,6,5,9,97.54545454545455,192,8,181,578,,,
0,33,1,1,1,0,759,12,2,10,38,120.66666666666667,344,9,204,555,,,
0,35,1,3,2,0,759,11,9,2,10,139.0,519,20,206,553,1.0,107.0,107.0
1,35,1,2,1,1,758,8,3,5,27,279.875,850,35,196,562,2.0,102.0,229.0
0,28,0,4,0,1,757,15,8,7,43,1001.3333333333334,12381,27,191,566,1.0,149.0,149.0
0,31,0,2,2,1,756,12,9,3,9,122.75,331,11,198,558,,,
1,25,0,2,2,0,756,11,6,5,30,175.8181818181818,611,9,194,562,,,
1,33,1,9,0,3,756,10,4,6,9,246.1,727,4,208,548,2.0,33.0,112.0
0,41,0,7,2,0,752,24,11,13,11,182.33333333333334,529,5,195,557,,,
0,40,0,3,1,0,751,14,8,6,11,126.35714285714286,499,31,167,584,,,
0,40,1,7,2,1,751,12,8,4,7,177.08333333333334,460,8,202,549,,,
0,35,0,6,0,1,748,15,6,9,27,1140.6,15273,1,201,547,,,
0,35,1,2,0,1,748,20,11,9,6,139.0,492,2,203,545,,,
0,44,0,9,2,0,747,11,5,6,10,127.45454545454545,247,13,173,574,1.0,61.0,61.0
0,43,0,1,3,3,746,21,12,9,3,123.19047619047619,306,4,206,540,,,
0,34,1,2,2,3,746,14,8,6,17,211.35714285714286,1141,9,207,539,,,
0,34,0,7,1,0,746,9,5,4,39,255.22222222222223,526,30,166,580,,,
0,29,1,3,0,1,745,13,7,6,20,932.7692307692307,9313,17,205,540,,,
0,34,0,7,0,1,743,23,11,12,8,177.2608695652174,587,15,207,536,,,
0,35,1,7,1,0,743,11,9,2,22,1216.1818181818182,11309,6,198,545,,,
1,34,1,9,1,2,742,10,4,6,14,179.9,376,19,196,546,2.0,137.0,157.0
0,32,0,3,2,0,740,11,3,8,5,94.9090909090909,190,45,208,532,,,
0,36,0,4,0,0,740,18,9,9,8,118.16666666666667,288,5,191,549,,,
0,39,0,4,3,1,739,18,6,12,4,233.77777777777777,538,3,196,543,,,
1,28,1,6,1,2,737,6,3,3,9,278.3333333333333,741,8,182,555,1.0,4.0,4.0
0,39,1,7,1,1,736,12,6,6,12,136.83333333333334,494,18,209,527,1.0,57.0,57.0
0,35,0,7,0,0,736,20,9,11,20,161.8,448,1,207,529,,,
0,25,0,2,1,0,736,20,9,11,13,157.8,513,2,192,544,,,
0,35,0,3,1,1,731,13,7,6,3,196.84615384615384,601,49,182,549,,,
0,37,1,9,1,0,731,10,3,7,20,122.6,301,11,206,525,,,
0,33,0,1,2,1,730,9,3,6,7,92.22222222222223,275,8,198,532,,,
0,36,1,2,1,0,726,14,8,6,3,152.21428571428572,542,53,197,529,,,
0,35,1,7,0,0,725,13,2,11,12,146.92307692307693,495,7,178,547,,,
0,32,1,3,0,0,724,20,12,8,5,183.5,728,16,206,518,,,
1,33,1,2,0,2,721,10,7,3,70,248.0,903,10,203,518,,,
0,31,1,7,4,1,720,25,14,11,4,129.12,298,1,209,511,1.0,12.0,12.0
0,27,0,5,3,1,717,10,7,3,6,140.9,274,8,191,526,,,
0,26,1,2,1,1,717,22,15,7,16,725.7727272727273,11858,2,198,519,,,
0,32,1,7,0,0,717,16,11,5,8,175.625,435,7,204,513,,,
0,37,0,3,1,2,716,17,8,9,30,165.1764705882353,774,9,202,514,,,
1,28,1,7,3,1,713,10,6,4,35,266.0,916,25,179,534,,,
0,36,0,1,2,0,712,10,4,6,27,124.6,269,9,195,517,,,
0,40,1,7,1,0,712,21,12,9,45,771.4761904761905,12957,10,190,522,,,
0,35,1,2,0,0,710,14,8,6,33,190.57142857142858,418,9,206,504,,,
0,33,1,7,1,0,710,12,5,7,47,128.91666666666666,389,5,181,529,,,
0,30,1,9,0,0,710,8,5,3,18,153.25,348,13,186,524,,,
0,43,0,7,2,0,709,8,6,2,5,133.875,304,2,203,506,,,
0,35,1,2,1,2,708,16,8,8,3,124.4375,256,3,205,503,1.0,40.0,40.0
0,41,1,6,2,1,708,15,8,7,1,134.93333333333334,697,14,202,506,,,
0,50,0,2,1,3,707,14,10,4,5,204.57142857142858,413,8,186,521,,,
0,40,0,3,2,0,706,11,8,3,1,151.45454545454547,391,35,200,506,1.0,125.0,125.0
0,41,0,2,1,0,703,18,10,8,8,188.83333333333334,451,19,208,495,,,
0,40,1,8,0,0,702,10,6,4,2,1047.6,8812,6,196,506,,,
0,31,0,3,1,0,702,15,6,9,10,134.0,382,3,196,506,,,
0,34,1,7,2,1,701,12,3,9,16,168.58333333333334,465,14,197,504,,,
0,27,1,7,3,1,701,9,2,7,3,147.22222222222223,430,66,182,519,,,
0,30,0,2,4,1,699,16,5,11,3,160.375,684,48,209,490,,,
0,29,1,9,4,0,698,35,13,22,1,199.05714285714285,730,11,207,491,,,
0,43,1,6,0,1,697,17,7,10,2,180.58823529411765,592,14,182,515,,,
1,30,1,7,1,2,697,7,2,5,9,305.14285714285717,929,9,203,494,,,
0,36,1,6,1,0,697,14,9,5,6,203.28571428571428,467,2,207,490,,,
0,33,0,3,4,1,696,16,7,9,3,144.625,497,31,199,497,,,
0,39,0,3,1,1,695,11,8,3,32,153.27272727272728,268,25,206,489,,,
1,35,1,3,1,2,695,11,5,6,28,131.72727272727272,384,13,204,491,1.0,6.0,6.0
0,24,0,7,1,0,695,11,4,7,3,586.1818181818181,5342,3,209,486,,,
0,30,1,7,1,0,695,14,10,4,6,220.35714285714286,582,4,192,503,1.0,187.0,187.0
0,36,0,7,1,1,693,12,5,7,5,131.33333333333334,458,23,185,508,,,
0,33,0,3,0,0,692,18,4,14,2,160.22222222222223,296,4,199,493,1.0,34.0,34.0
0,34,0,4,2,0,692,13,5,8,10,925.3076923076923,9869,21,205,487,,,
0,35,0,7,1,1,692,17,8,9,30,156.2941176470588,371,37,205,487,,,
0,38,1,2,2,0,692,15,9,6,32,213.2,659,23,198,494,,,
0,42,0,7,0,1,690,14,7,7,46,176.35714285714286,488,4,201,489,,,
0,40,1,5,2,0,687,9,4,5,11,105.11111111111111,200,1,201,486,,,
0,40,1,7,3,0,686,12,5,7,21,175.0,712,1,203,483,1.0,353.0,353.0
0,29,1,4,0,1,686,11,6,5,45,1060.1818181818182,9377,8,202,484,,,
0,36,1,7,0,0,685,17,8,9,8,207.0,603,7,189,496,,,
1,37,1,8,1,2,683,20,11,9,16,226.45,752,1,174,509,2.0,5.0,41.0
0,33,1,2,0,1,683,15,9,6,11,175.2,528,10,206,477,,,
0,36,0,6,1,0,682,15,8,7,9,112.73333333333333,339,2,151,531,1.0,75.0,75.0
0,33,0,9,0,1,681,17,11,6,19,142.23529411764707,527,3,201,480,,,
0,30,1,2,2,2,681,14,6,8,1,189.71428571428572,495,19,189,492,,,
0,39,1,3,0,1,681,14,7,7,24,126.5,405,13,203,478,,,
1,50,1,2,0,3,680,10,5,5,40,310.3,747,7,113,567,2.0,76.0,143.0
0,36,0,7,1,0,680,20,9,11,2,162.75,491,25,170,510,,,
0,36,1,3,0,1,678,18,8,10,24,226.61111111111111,632,1,203,475,,,
0,33,1,6,0,1,677,18,9,9,9,127.72222222222223,328,3,208,469,,,
0,40,1,1,0,0,677,14,6,8,28,137.42857142857142,492,17,208,469,,,
0,43,0,7,1,0,676,12,6,6,31,127.0,374,75,203,473,,,
1,46,0,4,2,0,674,11,8,3,59,242.45454545454547,814,3,189,485,2.0,37.0,138.0
0,32,0,7,2,0,674,16,11,5,2,214.25,740,1,209,465,,,
1,50,1,6,1,2,674,9,3,6,5,269.8888888888889,867,24,201,473,1.0,291.0,291.0
0,37,0,3,1,1,673,10,4,6,40,555.3,4318,3,203,470,1.0,35.0,35.0
0,42,0,2,0,0,673,15,7,8,13,166.66666666666666,503,9,204,469,,,
0,33,0,7,2,1,672,10,5,5,9,170.9,472,14,196,476,,,
0,38,1,5,3,0,672,9,5,4,30,113.0,276,9,186,486,1.0,260.0,260.0
0,28,0,7,4,0,671,10,6,4,24,149.5,564,38,175,496,1.0,16.0,16.0
0,41,0,8,1,2,670,16,10,6,16,173.75,463,19,205,465,,,
0,33,0,7,0,3,669,24,12,12,5,150.41666666666666,472,4,201,468,,,
0,38,1,2,2,0,667,22,15,7,1,174.63636363636363,438,1,196,471,,,
0,37,0,6,2,0,666,12,5,7,3,263.9166666666667,708,16,154,512,,,
0,31,1,3,1,0,663,7,4,3,9,148.14285714285714,329,13,171,492,,,
0,34,1,6,4,1,663,13,7,6,23,179.3846153846154,438,16,206,457,,,
0,33,1,1,1,0,663,24,10,14,3,154.29166666666666,474,1,209,454,,,
0,34,0,8,0,1,662,20,12,8,10,171.4,453,27,201,461,,,
0,31,1,6,1,0,661,20,12,8,3,195.6,543,2,206,455,,,
1,36,0,7,2,0,661,6,3,3,8,212.33333333333334,854,3,195,466,1.0,349.0,349.0
0,27,1,8,0,1,658,10,8,2,42,206.6,456,64,194,464,,,
0,37,1,2,4,1,657,17,5,12,12,143.11764705882354,508,3,205,452,,,
1,34,1,7,1,2,657,10,5,5,24,330.7,921,27,196,461,1.0,318.0,318.0
0,25,0,7,2,0,656,19,12,7,8,152.78947368421052,376,26,170,486,,,
0,33,0,3,4,1,655,13,7,6,5,191.69230769230768,518,7,208,447,,,
0,36,1,7,2,0,654,18,8,10,2,162.83333333333334,310,13,150,504,,,
0,35,1,8,1,0,654,12,4,8,23,219.83333333333334,536,2,203,451,1.0,261.0,261.0
0,32,1,2,0,1,653,12,4,8,31,217.08333333333334,524,12,208,445,,,
0,30,0,7,3,1,651,14,7,7,23,181.85714285714286,577,11,178,473,,,
0,30,0,2,1,0,650,12,8,4,62,215.5,642,59,192,458,,,
1,36,1,7,1,2,650,11,5,6,73,232.36363636363637,847,2,184,466,,,
0,27,0,7,4,1,649,14,7,7,3,192.64285714285714,436,29,209,440,,,
0,34,1,1,3,1,648,17,9,8,16,361.4117647058824,3257,4,179,469,,,
1,38,1,3,1,2,647,7,2,5,25,168.14285714285714,405,21,107,540,1.0,291.0,291.0
0,28,1,3,4,1,646,13,6,7,3,189.30769230769232,468,18,203,443,1.0,293.0,293.0
0,32,0,2,1,0,646,20,7,13,8,183.3,640,3,183,463,,,
0,36,1,7,0,1,645,13,8,5,5,130.07692307692307,397,5,205,440,,,
0,36,0,1,0,1,645,15,4,11,52,147.2,323,1,193,452,1.0,108.0,108.0
0,33,1,7,1,0,645,9,4,5,21,179.33333333333334,737,39,206,439,1.0,59.0,59.0
1,34,1,5,1,2,644,10,5,5,20,167.6,362,7,182,462,1.0,1.0,1.0
0,31,1,3,2,0,642,16,11,5,9,118.6875,300,1,185,457,,,
0,44,0,1,0,1,642,16,8,8,36,202.75,463,9,207,435,,,
0,38,0,5,1,0,642,21,8,13,3,137.1904761904762,486,9,204,438,,,
0,39,0,3,2,2,641,18,9,9,2,180.38888888888889,436,8,194,447,1.0,29.0,29.0
0,43,0,2,1,1,641,27,15,12,8,174.4814814814815,643,8,209,432,,,
0,33,0,2,2,0,641,16,5,11,24,157.125,389,33,195,446,,,
0,40,0,6,1,0,636,13,5,8,13,122.6923076923077,309,24,208,428,,,
0,35,1,3,2,0,636,17,9,8,4,145.8235294117647,700,14,200,436,,,
0,36,1,8,2,2,635,22,9,13,14,204.86363636363637,507,10,208,427,,,
0,44,0,7,2,0,634,14,7,7,39,1058.0714285714287,11973,9,192,442,,,
1,39,1,1,1,2,634,8,5,3,39,225.875,352,2,146,488,1.0,12.0,12.0
0,35,1,2,3,1,634,15,8,7,8,125.2,313,9,191,443,,,
0,35,1,6,3,0,633,16,9,7,8,136.0625,388,7,207,426,,,
1,33,1,3,4,0,632,8,2,6,33,148.875,522,11,180,452,1.0,11.0,11.0
0,42,0,2,1,0,632,12,5,7,2,164.58333333333334,411,16,179,453,,,
0,37,1,7,0,1,632,12,6,6,26,138.58333333333334,420,20,161,471,,,
0,32,0,7,2,0,631,19,8,11,9,794.8421052631579,12418,10,204,427,1.0,101.0,101.0
0,23,0,2,1,0,631,19,10,9,26,164.68421052631578,393,2,184,447,1.0,96.0,96.0
0,30,1,8,1,0,630,22,10,12,15,779.7727272727273,13945,23,193,437,,,
0,38,0,7,2,0,629,20,11,9,12,140.1,419,10,208,421,,,
0,37,0,7,1,0,626,19,11,8,7,140.05263157894737,491,21,208,418,,,
0,38,0,3,3,0,625,15,9,6,36,228.2,551,6,200,425,,,
0,42,0,6,0,1,621,19,9,10,15,165.26315789473685,595,5,194,427,1.0,96.0,96.0
0,43,0,2,1,1,621,25,14,11,2,126.68,602,21,206,415,,,
0,41,1,8,2,0,620,18,9,9,16,166.94444444444446,446,7,180,440,,,
0,34,0,7,3,3,617,19,11,8,11,149.0,429,5,201,416,,,
1,38,1,3,1,2,617,7,2,5,28,364.7142857142857,934,14,142,475,2.0,5.0,11.0
1,41,1,9,1,2,617,10,8,2,18,234.3,925,6,183,434,2.0,43.0,112.0
0,28,1,8,1,0,616,17,6,11,3,108.29411764705883,386,12,191,425,1.0,8.0,8.0
0,36,1,3,1,0,614,13,6,7,45,195.07692307692307,461,25,209,405,1.0,45.0,45.0
0,43,0,3,3,0,613,17,7,10,6,181.0,375,14,202,411,,,
0,32,0,2,4,1,613,11,6,5,27,140.63636363636363,434,3,174,439,,,
0,25,0,5,1,0,613,13,7,6,5,204.53846153846155,719,3,201,412,,,
0,28,1,8,4,0,613,14,6,8,6,185.57142857142858,460,1,178,435,1.0,151.0,151.0
0,36,0,7,1,0,613,15,7,8,1,129.0,301,4,165,448,,,
0,35,0,7,2,0,612,12,4,8,3,127.91666666666667,432,21,184,428,,,
0,27,0,7,1,2,612,14,8,6,52,198.28571428571428,483,18,204,408,,,
0,29,1,7,1,1,610,19,11,8,5,253.73684210526315,787,7,205,405,,,
1,32,1,2,1,2,610,10,6,4,3,152.9,821,9,188,422,1.0,40.0,40.0
0,31,0,2,3,3,608,20,11,9,9,135.35,405,7,204,404,,,
0,43,0,5,0,1,606,25,8,17,3,195.56,480,1,208,398,2.0,2.0,31.0
0,32,1,7,1,1,606,12,2,10,20,191.5,464,17,196,410,,,
0,36,0,1,0,1,603,16,9,7,60,253.25,664,23,206,397,1.0,71.0,71.0
0,35,1,3,0,2,603,6,4,2,3,129.16666666666666,276,17,191,412,,,
0,41,1,3,0,0,601,13,9,4,21,109.3076923076923,267,5,198,403,,,
0,37,0,7,2,0,600,15,10,5,7,144.26666666666668,416,31,172,428,,,
0,32,0,7,1,2,599,13,5,8,27,160.3846153846154,386,28,195,404,,,
0,31,0,7,2,0,598,13,7,6,38,216.6153846153846,588,23,194,404,1.0,21.0,21.0
0,37,0,6,3,1,596,13,9,4,7,237.69230769230768,662,17,208,388,1.0,74.0,74.0
0,37,1,2,1,3,592,12,5,7,41,166.33333333333334,595,7,192,400,,,
0,31,1,7,1,0,592,10,6,4,20,481.2,3147,42,187,405,,,
0,34,0,7,2,1,591,14,7,7,5,250.07142857142858,552,8,206,385,1.0,76.0,76.0
0,36,0,7,0,0,590,16,11,5,8,186.1875,634,1,205,385,,,
0,27,0,2,0,1,586,23,11,12,4,127.78260869565217,380,8,205,381,,,
0,38,0,7,4,3,585,13,5,8,13,192.0,614,2,181,404,,,
0,37,0,2,1,0,585,18,9,9,9,739.2222222222222,11149,28,204,381,,,
0,39,0,6,2,0,585,14,11,3,8,218.92857142857142,637,15,188,397,1.0,130.0,130.0
0,36,1,2,2,0,584,24,13,11,1,163.75,488,1,199,385,1.0,120.0,120.0
0,44,1,7,4,2,583,17,5,12,14,165.1764705882353,351,36,201,382,,,
0,34,1,3,4,1,583,9,4,5,25,126.44444444444444,328,2,147,436,,,
0,41,0,8,1,0,583,15,8,7,22,146.33333333333334,769,9,205,378,,,
0,44,1,3,0,1,581,18,7,11,12,135.88888888888889,619,2,179,402,,,
0,32,1,1,2,2,580,12,7,5,10,112.41666666666667,348,15,190,390,,,
0,35,1,2,0,1,580,17,7,10,1,149.58823529411765,511,39,202,378,,,
0,34,0,5,2,0,579,16,8,8,2,127.1875,389,4,207,372,,,
1,35,1,3,1,2,578,11,8,3,11,139.63636363636363,459,17,164,414,2.0,39.0,231.0
0,33,0,7,1,2,576,12,7,5,30,287.4166666666667,668,3,167,409,,,
0,32,1,2,4,1,574,18,6,12,21,453.44444444444446,4824,8,208,366,,,
0,37,0,2,0,1,572,6,3,3,10,188.33333333333334,430,53,203,369,,,
0,36,0,1,0,1,571,17,6,11,34,261.7647058823529,749,38,200,371,,,
0,35,0,2,3,2,570,14,7,7,66,253.07142857142858,514,1,188,382,,,
0,27,1,7,4,1,569,15,10,5,30,216.2,587,9,193,376,,,
0,34,0,4,1,0,568,13,8,5,37,173.0,588,2,186,382,1.0,73.0,73.0
0,29,0,7,0,0,566,13,5,8,8,153.69230769230768,404,1,207,359,1.0,30.0,30.0
0,31,1,6,0,0,565,11,4,7,20,181.45454545454547,468,16,204,361,,,
0,34,0,7,0,1,564,13,4,9,7,157.30769230769232,397,2,201,363,,,
0,33,0,6,1,0,564,21,10,11,2,181.1904761904762,594,3,209,355,,,
0,41,0,3,4,0,563,19,5,14,4,157.3684210526316,467,10,187,376,,,
0,30,1,9,1,0,563,18,11,7,9,222.44444444444446,438,2,185,378,,,
0,33,0,2,3,1,563,19,12,7,4,395.57894736842104,4011,3,196,367,,,
0,33,0,2,2,2,562,8,2,6,32,185.5,487,17,209,353,,,
0,40,0,7,0,1,560,13,6,7,2,206.07692307692307,631,14,197,363,,,
1,36,1,6,1,1,560,7,3,4,15,333.14285714285717,866,26,176,384,,,
0,26,1,7,1,0,558,12,6,6,15,129.58333333333334,278,4,207,351,,,
0,33,1,7,2,0,557,13,10,3,2,186.76923076923077,569,29,203,354,,,
0,25,0,7,0,0,557,36,17,19,6,175.19444444444446,675,2,199,358,,,
0,32,0,3,0,3,557,17,7,10,4,163.88235294117646,612,20,209,348,,,
0,30,0,2,1,0,557,34,19,15,9,145.94117647058823,724,10,197,360,1.0,51.0,51.0
0,43,0,2,3,0,555,15,6,9,3,111.26666666666667,600,2,190,365,,,
0,33,0,1,1,1,555,13,8,5,8,125.84615384615384,284,6,135,420,,,
0,32,1,7,2,0,551,19,11,8,3,152.10526315789474,490,12,181,370,,,
0,35,0,2,1,0,551,11,3,8,13,103.54545454545455,222,43,151,400,,,
0,35,1,6,0,1,550,15,8,7,16,143.8,391,4,207,343,,,
0,35,0,2,1,0,549,14,7,7,4,144.14285714285714,302,40,195,354,,,
1,30,1,8,0,2,546,10,4,6,14,200.3,804,7,164,382,1.0,169.0,169.0
0,33,0,5,1,0,545,17,9,8,3,237.11764705882354,530,7,194,351,,,
0,34,1,2,3,1,545,9,3,6,14,167.88888888888889,616,9,203,342,,,
0,33,1,6,2,0,545,11,6,5,16,128.45454545454547,351,13,200,345,,,
0,34,0,3,2,0,543,16,11,5,8,127.6875,370,2,191,352,,,
0,31,0,7,1,0,542,11,5,6,4,196.9090909090909,658,1,189,353,,,
0,30,0,8,0,1,542,19,9,10,20,192.26315789473685,410,9,192,350,,,
0,35,0,7,0,1,541,15,6,9,50,184.46666666666667,413,23,175,366,,,
0,27,0,9,0,0,540,19,8,11,10,340.94736842105266,3766,11,180,360,1.0,49.0,49.0
0,39,1,2,1,0,540,7,3,4,36,122.42857142857143,344,9,179,361,,,
0,49,0,3,1,0,539,16,10,6,10,1119.0,15402,13,208,331,,,
0,46,0,7,0,0,539,17,9,8,5,159.41176470588235,476,19,202,337,,,
0,40,0,1,1,0,538,20,9,11,4,132.05,563,4,209,329,,,
0,49,1,4,0,1,536,19,10,9,2,196.68421052631578,621,13,203,333,,,
0,35,1,7,0,0,535,18,10,8,15,148.16666666666666,415,22,209,326,,,
0,34,1,8,2,0,535,17,9,8,12,166.8235294117647,679,5,209,326,1.0,64.0,64.0
0,34,1,2,3,2,535,14,4,10,2,160.64285714285714,306,2,207,328,,,
0,25,1,5,2,1,534,10,6,4,49,177.5,497,52,182,352,,,
0,35,1,2,1,0,534,19,12,7,32,178.89473684210526,522,12,193,341,1.0,318.0,318.0
0,40,0,1,2,0,533,12,5,7,25,146.5,309,32,200,333,,,
1,36,1,7,0,2,533,7,3,4,14,141.28571428571428,219,55,162,371,,,
0,40,1,4,0,1,533,11,5,6,28,174.45454545454547,406,15,179,354,,,
0,41,0,2,4,1,532,16,8,8,12,228.0,589,8,206,326,,,
0,38,0,8,1,0,532,17,10,7,16,184.35294117647058,586,6,204,328,,,
1,27,1,3,4,0,531,11,7,4,19,223.72727272727272,775,7,205,326,2.0,4.0,76.0
0,37,0,7,0,1,531,14,6,8,1,191.14285714285714,690,21,199,332,,,
0,33,0,7,0,0,529,14,5,9,1,170.07142857142858,508,12,205,324,,,
0,36,1,2,2,0,529,15,6,9,5,159.4,467,1,206,323,,,
0,43,0,8,2,0,529,22,11,11,1,173.13636363636363,567,7,208,321,,,
0,27,0,2,1,0,529,19,5,14,6,696.421052631579,9584,1,182,347,,,
0,40,1,2,2,1,528,14,6,8,19,151.07142857142858,592,9,190,338,1.0,134.0,134.0
0,34,1,2,1,2,527,8,6,2,11,129.125,380,19,209,318,,,
0,40,1,6,1,0,526,10,3,7,6,131.3,522,67,173,353,,,
0,29,0,7,2,0,525,13,5,8,19,425.2307692307692,3442,3,179,346,,,
0,40,1,3,3,0,524,13,8,5,12,122.15384615384616,408,1,186,338,,,
0,40,1,6,4,1,524,17,9,8,9,131.58823529411765,358,5,191,333,,,
0,35,0,2,2,0,522,11,4,7,10,152.36363636363637,477,46,155,367,2.0,43.0,43.0
0,34,0,2,0,0,522,20,13,7,11,141.45,523,8,195,327,,,
0,23,0,7,3,0,522,15,8,7,8,858.1333333333333,10526,29,200,322,,,
0,34,1,7,4,0,522,18,11,7,11,174.5,642,2,197,325,,,
0,41,0,8,1,1,522,14,8,6,3,138.71428571428572,359,49,209,313,,,
0,37,0,8,1,0,522,15,8,7,6,76.93333333333334,291,4,203,319,,,
0,31,1,3,1,0,520,17,7,10,2,222.76470588235293,644,23,186,334,,,
0,33,1,2,1,3,519,20,6,14,2,206.0,480,5,199,320,1.0,260.0,260.0
1,27,1,2,1,2,519,11,8,3,23,272.54545454545456,799,1,168,351,,,
1,38,1,8,0,3,519,7,4,3,6,155.0,484,11,208,311,1.0,76.0,76.0
0,44,0,9,0,1,518,10,4,6,28,274.3,667,13,185,333,,,
0,42,1,3,2,2,517,20,6,14,2,323.55,2467,4,206,311,,,
0,38,1,4,0,1,517,18,10,8,2,147.33333333333334,340,17,188,329,,,
0,32,0,7,1,0,517,16,8,8,2,132.3125,311,41,204,313,,,
0,34,1,8,3,1,516,15,6,9,5,661.9333333333333,8438,19,206,310,,,
0,34,1,7,1,1,515,15,5,10,15,209.66666666666666,536,47,207,308,,,
0,29,0,3,0,1,515,20,9,11,17,160.85,379,4,207,308,1.0,125.0,125.0
0,43,1,7,0,1,512,13,7,6,52,169.69230769230768,419,8,209,303,,,
1,31,1,2,0,3,512,8,1,7,15,238.75,861,8,164,348,1.0,35.0,35.0
0,30,1,7,2,0,508,9,5,4,29,99.22222222222223,189,11,204,304,,,
0,31,1,2,0,1,507,11,5,6,19,100.81818181818181,207,61,207,300,,,
0,36,1,7,0,0,507,11,4,7,2,181.0,685,7,194,313,1.0,190.0,190.0
0,26,0,2,1,1,507,37,20,17,1,155.1891891891892,459,3,209,298,,,
0,33,0,2,4,2,506,14,6,8,19,102.85714285714286,247,29,192,314,,,
0,36,1,1,0,0,504,14,7,7,8,164.57142857142858,580,25,185,319,,,
0,29,0,6,1,0,504,18,11,7,9,99.11111111111111,419,5,199,305,,,
1,23,1,8,1,2,502,9,6,3,2,81.22222222222223,203,10,162,340,1.0,319.0,319.0
0,43,1,7,0,1,502,11,5,6,11,100.0909090909091,539,7,151,351,,,
0,36,0,8,0,1,498,10,6,4,10,142.8,466,4,193,305,,,
0,43,1,7,0,1,496,15,7,8,2,215.73333333333332,528,16,207,289,2.0,157.0,318.0
0,33,1,1,1,0,495,11,6,5,14,119.0,418,12,205,290,1.0,21.0,21.0
0,40,1,2,1,2,493,17,6,11,32,159.1764705882353,329,24,197,296,1.0,142.0,142.0
0,32,0,8,0,1,491,10,4,6,52,175.0,427,22,206,285,,,
0,33,0,7,3,1,489,16,6,10,1,132.4375,369,9,205,284,1.0,76.0,76.0
1,38,1,6,0,3,488,11,5,6,39,211.9090909090909,924,4,186,302,1.0,32.0,32.0
0,33,0,2,1,1,488,10,7,3,2,150.1,376,17,201,287,,,
0,31,0,7,3,0,487,13,5,8,10,118.15384615384616,390,52,184,303,1.0,7.0,7.0
0,40,0,4,1,1,485,22,10,12,7,145.13636363636363,437,37,209,276,,,
0,30,1,3,1,0,485,13,6,7,12,176.53846153846155,476,33,181,304,,,
0,38,0,2,0,1,485,23,10,13,14,188.17391304347825,439,19,206,279,,,
0,37,1,9,2,0,483,23,11,12,12,196.95652173913044,519,4,207,276,,,
0,30,0,8,0,0,481,11,4,7,17,135.36363636363637,311,14,200,281,,,
1,32,1,1,0,3,480,6,3,3,19,153.0,444,16,129,351,1.0,40.0,40.0
0,44,1,7,0,1,479,11,5,6,4,165.0909090909091,426,35,203,276,,,
0,35,0,7,3,0,479,14,8,6,23,146.07142857142858,391,2,209,270,,,
0,32,1,2,0,1,478,16,6,10,28,295.25,648,19,183,295,,,
0,37,1,8,1,0,476,14,5,9,19,158.14285714285714,294,23,201,275,1.0,1.0,1.0
0,40,1,1,0,1,475,14,6,8,2,140.0,498,10,197,278,,,
0,35,1,2,2,0,474,9,7,2,37,173.66666666666666,289,24,173,301,1.0,36.0,36.0
0,31,1,4,3,3,473,13,7,6,17,145.69230769230768,270,27,207,266,,,
0,32,0,2,3,3,472,10,3,7,25,130.7,417,29,201,271,,,
0,44,0,7,1,0,472,12,3,9,2,96.41666666666667,324,12,185,287,1.0,170.0,170.0
0,45,0,2,0,0,471,13,5,8,13,178.46153846153845,386,37,205,266,,,
0,37,0,3,3,0,471,32,15,17,2,249.59375,4589,10,208,263,,,
0,37,1,7,3,1,469,12,5,7,23,182.75,473,4,198,271,,,
0,31,0,9,1,0,468,15,11,4,2,150.0,461,15,196,272,,,
0,37,0,3,1,0,468,6,4,2,82,193.0,275,1,158,310,2.0,94.0,229.0
1,44,1,2,1,2,466,8,6,2,29,306.75,777,6,53,413,1.0,46.0,46.0
0,36,1,2,2,1,463,12,3,9,7,143.08333333333334,343,4,208,255,1.0,135.0,135.0
1,37,1,8,1,2,462,9,3,6,22,140.77777777777777,260,5,192,270,1.0,28.0,28.0
0,42,0,3,2,1,461,12,6,6,29,162.0,361,61,203,258,,,
0,44,0,3,0,1,461,17,10,7,7,109.05882352941177,251,9,206,255,,,
0,34,1,7,1,0,459,17,8,9,11,119.0,317,44,205,254,1.0,4.0,4.0
0,32,0,7,4,3,458,8,3,5,7,131.25,272,21,165,293,,,
0,26,1,2,3,0,457,12,7,5,16,1351.3333333333333,14974,34,150,307,,,
0,43,0,3,0,1,455,10,5,5,2,140.9,304,26,207,248,,,
0,32,1,2,0,0,452,7,3,4,2,200.0,338,14,209,243,,,
0,40,1,8,1,1,449,12,6,6,30,197.5,422,28,170,279,,,
1,42,1,1,3,1,449,5,2,3,82,186.0,242,8,195,254,1.0,318.0,318.0
1,40,1,7,4,0,444,18,7,11,12,223.61111111111111,894,12,198,246,3.0,5.0,63.0
0,38,1,1,0,0,441,14,8,6,16,185.35714285714286,486,24,205,236,1.0,186.0,186.0
1,42,1,3,0,3,440,11,5,6,23,165.45454545454547,794,13,156,284,1.0,9.0,9.0
0,33,1,8,4,1,440,12,6,6,23,224.25,538,33,181,259,,,
0,45,0,2,2,0,440,15,7,8,3,128.0,385,15,207,233,1.0,130.0,130.0
0,36,1,1,1,1,438,14,9,5,20,200.35714285714286,602,9,201,237,,,
0,31,1,3,0,1,438,15,10,5,28,136.33333333333334,293,51,201,237,,,
0,42,0,3,1,0,437,10,8,2,3,171.5,434,8,156,281,,,
0,28,1,3,4,1,436,20,11,9,3,138.55,592,12,202,234,,,
0,46,1,5,1,0,436,11,7,4,26,150.1818181818182,320,22,165,271,,,
0,45,0,5,2,0,435,15,8,7,4,154.8,359,11,172,263,,,
0,38,1,7,1,0,434,16,7,9,13,172.875,466,19,205,229,,,
0,27,1,7,0,1,434,6,3,3,1,155.5,418,83,188,246,,,
0,47,0,6,0,1,433,14,12,2,27,204.5,540,32,209,224,,,
0,37,1,3,1,0,432,8,4,4,7,190.25,421,22,120,312,,,
0,38,0,7,4,2,431,15,10,5,7,227.46666666666667,767,22,208,223,1.0,202.0,202.0
0,32,0,7,0,1,431,15,8,7,8,129.4,385,28,198,233,,,
0,40,0,8,0,1,430,5,3,2,115,201.8,388,2,186,244,,,
0,32,1,2,2,3,429,13,6,7,2,153.76923076923077,405,8,205,224,1.0,139.0,139.0
0,29,0,8,0,1,428,12,4,8,7,103.83333333333333,404,10,169,259,,,
0,28,0,2,1,0,426,18,7,11,7,163.61111111111111,369,14,209,217,,,
0,34,0,1,0,0,422,23,9,14,4,183.43478260869566,448,10,199,223,1.0,15.0,15.0
0,42,1,3,0,1,422,14,10,4,25,224.14285714285714,635,15,175,247,,,
0,34,0,1,0,0,422,19,7,12,1,170.78947368421052,451,3,209,213,,,
0,23,1,7,4,0,420,15,8,7,6,159.8,488,1,200,220,1.0,320.0,320.0
0,30,0,1,4,2,419,11,2,9,17,248.72727272727272,645,24,177,242,,,
0,36,1,2,1,0,419,24,12,12,2,147.70833333333334,524,14,207,212,,,
0,35,0,8,0,1,419,15,7,8,31,237.06666666666666,591,3,202,217,,,
0,40,1,5,0,0,415,10,4,6,1,144.9,599,4,188,227,1.0,39.0,39.0
0,35,1,2,2,0,413,10,7,3,6,180.7,602,15,180,233,1.0,12.0,12.0
0,32,0,8,0,0,411,14,9,5,27,167.5,512,18,190,221,,,
0,36,1,6,2,0,409,14,8,6,2,109.92857142857143,319,4,205,204,,,
0,36,1,8,4,0,408,15,7,8,9,153.2,384,7,181,227,,,
0,36,1,5,4,0,407,16,4,12,4,158.5625,360,50,181,226,1.0,203.0,203.0
0,26,0,7,3,1,404,11,8,3,3,102.63636363636364,491,8,200,204,,,
0,34,1,3,2,2,403,13,8,5,39,179.15384615384616,502,16,206,197,1.0,142.0,142.0
0,36,1,2,1,0,402,10,4,6,7,121.5,281,35,205,197,1.0,33.0,33.0
1,40,1,7,1,2,402,8,4,4,1,241.125,908,37,154,248,1.0,259.0,259.0
0,32,0,4,1,0,401,16,6,10,2,151.875,466,19,202,199,1.0,260.0,260.0
0,34,1,2,0,1,400,12,7,5,3,78.16666666666667,312,10,201,199,,,
0,31,1,6,1,0,400,23,10,13,10,226.17391304347825,417,3,198,202,,,
0,39,1,7,0,0,399,15,8,7,9,249.6,623,13,207,192,,,
0,31,1,7,0,0,398,19,11,8,3,146.26315789473685,486,1,192,206,,,
0,33,0,3,3,1,396,18,14,4,13,180.44444444444446,465,36,206,190,,,
0,39,0,2,3,1,396,11,5,6,4,123.18181818181819,348,7,182,214,,,
0,30,0,2,0,0,395,12,8,4,14,116.83333333333333,485,14,207,188,,,
0,29,0,7,2,1,395,13,5,8,27,188.53846153846155,676,6,187,208,,,
0,42,1,6,3,1,393,13,9,4,1,163.46153846153845,463,5,205,188,,,
0,34,1,1,1,0,393,13,5,8,1,159.15384615384616,622,53,208,185,,,
0,37,0,8,2,1,392,16,6,10,14,182.0625,540,6,202,190,,,
0,37,1,7,4,1,391,21,14,7,4,482.04761904761904,6886,4,205,186,,,
0,26,0,7,1,0,391,14,4,10,11,156.85714285714286,593,15,207,184,,,
0,35,0,2,3,0,390,13,6,7,2,195.23076923076923,674,16,200,190,2.0,102.0,163.0
0,34,1,8,4,0,389,7,6,1,30,181.85714285714286,402,30,206,183,1.0,173.0,173.0
0,40,1,2,2,0,385,17,12,5,5,165.11764705882354,398,4,206,179,,,
0,32,1,3,1,0,381,12,6,6,7,114.5,276,24,185,196,1.0,143.0,143.0
0,29,0,2,1,2,381,15,7,8,4,157.4,534,22,202,179,,,
1,31,1,3,1,2,380,5,2,3,29,303.6,763,18,59,321,1.0,2.0,2.0
0,33,0,7,3,2,379,11,4,7,70,248.9090909090909,535,37,153,226,1.0,10.0,10.0
0,33,1,2,0,1,379,15,6,9,3,164.53333333333333,443,11,194,185,,,
0,38,1,1,3,0,379,10,3,7,16,96.6,228,70,205,174,,,
0,33,1,3,2,0,378,16,6,10,10,179.9375,424,14,164,214,,,
0,38,1,3,2,3,377,18,12,6,10,690.5555555555555,8627,4,188,189,,,
1,39,1,3,3,1,377,10,6,4,36,283.2,762,1,181,196,,,
0,39,0,4,1,0,376,22,13,9,21,166.4090909090909,622,6,207,169,,,
1,34,1,8,0,3,376,6,2,4,84,229.83333333333334,472,9,156,220,,,
0,41,0,2,1,2,375,10,6,4,14,105.6,251,43,208,167,,,
0,31,0,5,0,1,375,16,5,11,14,227.8125,542,20,180,195,,,
0,27,1,7,1,1,371,20,8,12,17,133.35,361,11,206,165,,,
0,35,1,2,0,2,370,14,4,10,30,240.14285714285714,667,10,202,168,1.0,158.0,158.0
0,36,0,9,0,0,369,8,5,3,30,245.125,416,11,174,195,,,
0,35,1,3,1,0,369,17,9,8,4,233.52941176470588,657,2,198,171,1.0,33.0,33.0
0,55,0,3,1,0,367,12,4,8,17,184.08333333333334,375,30,198,169,3.0,4.0,295.0
0,25,1,5,1,0,367,19,10,9,10,176.73684210526315,531,17,201,166,,,
0,29,0,6,2,1,366,11,4,7,26,127.72727272727273,394,1,186,180,,,
0,37,1,8,1,0,366,15,5,10,2,127.06666666666666,469,16,197,169,,,
0,27,0,5,0,1,362,21,10,11,7,109.52380952380952,311,2,200,162,,,
0,31,0,9,1,0,362,14,9,5,8,127.92857142857143,343,2,161,201,1.0,36.0,36.0
0,34,1,3,3,0,362,16,8,8,5,192.0625,609,4,194,168,,,
0,28,1,7,4,1,359,19,7,12,6,167.78947368421052,380,7,188,171,,,
0,35,0,8,1,1,359,17,8,9,27,168.88235294117646,389,5,206,153,,,
0,35,1,2,0,0,359,21,12,9,2,118.04761904761905,415,8,203,156,,,
0,28,0,7,2,1,359,15,8,7,28,222.46666666666667,461,8,176,183,,,
0,39,0,7,0,1,359,6,4,2,8,103.16666666666667,205,20,152,207,1.0,260.0,260.0
0,26,0,8,0,1,359,21,9,12,2,179.57142857142858,522,2,204,155,1.0,235.0,235.0
0,28,1,2,1,0,359,16,8,8,8,89.375,203,14,193,166,,,
0,31,1,8,0,0,358,10,7,3,20,167.6,379,36,206,152,,,
0,37,0,6,2,0,358,7,3,4,9,256.85714285714283,605,17,179,179,2.0,46.0,322.0
0,41,1,3,1,0,357,18,6,12,3,110.5,345,9,190,167,,,
0,36,1,3,1,1,356,13,6,7,18,152.23076923076923,487,22,202,154,,,
0,38,1,7,2,1,354,18,7,11,18,243.27777777777777,815,6,209,145,,,
1,32,1,8,1,2,353,6,3,3,44,267.3333333333333,871,1,108,245,1.0,168.0,168.0
1,30,1,6,1,2,352,14,7,7,25,233.42857142857142,787,25,200,152,2.0,3.0,10.0
0,40,1,2,1,0,352,16,11,5,10,119.1875,496,12,208,144,,,
0,39,1,7,1,0,352,22,15,7,4,156.0,364,1,204,148,,,
0,42,1,5,1,2,350,19,11,8,4,136.57894736842104,514,5,186,164,,,
0,41,0,1,1,0,349,8,4,4,47,147.25,373,128,201,148,,,
0,34,0,6,1,0,349,16,8,8,20,170.9375,321,17,204,145,,,
0,36,1,7,0,1,346,16,8,8,9,169.4375,458,3,203,143,,,
0,25,0,2,0,0,346,19,8,11,5,157.3684210526316,484,7,197,149,1.0,4.0,4.0
0,33,1,3,0,0,346,14,7,7,5,165.57142857142858,438,11,184,162,,,
0,40,1,4,2,0,344,13,2,11,14,191.15384615384616,571,7,198,146,2.0,5.0,153.0
0,31,1,7,0,1,343,13,9,4,2,185.53846153846155,471,25,175,168,1.0,149.0,149.0
0,38,1,5,0,0,343,22,16,6,30,150.63636363636363,319,14,205,138,,,
0,45,0,6,1,0,342,18,11,7,3,287.5,2230,6,209,133,,,
0,41,0,3,2,3,342,11,8,3,32,129.45454545454547,269,8,201,141,,,
0,26,0,6,0,1,341,19,9,10,9,160.47368421052633,580,4,206,135,,,
1,24,1,2,0,3,341,8,3,5,44,225.875,741,2,93,248,,,
0,31,0,7,1,0,340,14,6,8,1,234.0,723,11,197,143,,,
0,35,1,1,0,1,339,11,6,5,9,139.72727272727272,344,18,188,151,,,
0,44,0,7,0,1,339,17,11,6,4,121.88235294117646,360,54,189,150,1.0,106.0,106.0
0,40,1,3,2,0,338,15,5,10,11,181.0,450,12,169,169,,,
0,33,1,5,1,0,337,17,8,9,33,134.11764705882354,378,33,194,143,,,
0,38,0,8,1,3,335,18,11,7,13,230.72222222222223,502,2,209,126,1.0,21.0,21.0
0,23,1,7,1,0,334,16,7,9,12,175.6875,670,16,207,127,,,
0,21,0,3,1,0,333,9,3,6,8,208.22222222222223,605,38,171,162,,,
0,32,0,3,0,1,332,16,7,9,19,134.75,487,3,204,128,,,
0,40,1,5,1,0,330,14,6,8,38,258.5,613,40,207,123,,,
0,31,0,7,3,1,329,17,6,11,22,198.1764705882353,568,25,206,123,1.0,166.0,166.0
0,35,0,7,4,3,329,7,2,5,5,138.28571428571428,457,97,196,133,,,
0,32,0,6,2,0,329,11,8,3,20,191.45454545454547,600,6,195,134,,,
0,35,1,7,2,1,328,19,11,8,1,200.89473684210526,706,4,205,123,,,
1,33,1,3,1,2,327,9,6,3,15,285.44444444444446,914,10,180,147,,,
0,41,0,7,0,2,326,18,11,7,3,213.11111111111111,483,2,209,117,,,
0,35,1,3,0,1,326,10,4,6,2,118.9,373,13,205,121,,,
0,33,1,7,4,1,325,14,6,8,18,166.42857142857142,432,9,182,143,,,
0,36,1,7,0,1,324,11,5,6,4,120.27272727272727,432,23,192,132,,,
0,30,0,2,2,0,324,15,8,7,20,207.8,562,4,207,117,,,
0,38,0,7,2,1,324,9,4,5,3,182.55555555555554,354,72,203,121,,,
0,37,0,2,0,1,323,16,7,9,6,147.9375,379,18,205,118,,,
0,29,1,2,0,1,320,14,4,10,9,167.71428571428572,350,15,198,122,,,
0,37,0,3,1,0,318,10,7,3,32,168.0,349,2,209,109,,,
0,30,0,7,1,0,318,16,11,5,1,85.4375,267,42,200,118,,,
0,41,1,2,1,0,317,22,12,10,6,168.6818181818182,457,1,193,124,1.0,186.0,186.0
0,35,1,6,1,1,316,10,3,7,26,222.9,648,15,209,107,1.0,131.0,131.0
0,43,0,2,0,1,316,13,6,7,15,68.3076923076923,196,2,204,112,2.0,65.0,109.0
0,34,0,7,0,2,315,14,6,8,25,214.35714285714286,572,41,174,141,,,
0,38,0,2,0,1,315,16,11,5,8,188.5625,684,29,209,106,,,
0,41,1,9,2,1,313,12,3,9,6,218.5,641,3,199,114,,,
0,26,0,3,1,0,311,5,3,2,15,138.2,326,62,150,161,,,
0,26,1,3,3,0,308,13,5,8,44,912.6923076923077,9052,13,198,110,,,
1,30,0,2,2,0,308,9,5,4,38,236.11111111111111,756,17,184,124,2.0,39.0,194.0
0,36,1,7,0,1,307,14,6,8,18,215.57142857142858,515,59,192,115,1.0,290.0,290.0
0,37,1,2,0,1,307,14,10,4,18,215.71428571428572,614,12,168,139,,,
0,42,0,7,0,0,305,15,3,12,1,99.73333333333333,268,9,197,108,1.0,12.0,12.0
0,27,1,2,2,2,304,11,5,6,19,194.0909090909091,403,25,195,109,1.0,181.0,181.0
0,37,0,2,3,1,303,17,7,10,29,582.5294117647059,6861,3,209,94,,,
0,32,1,2,0,1,302,14,7,7,18,193.28571428571428,469,3,207,95,,,
0,43,0,7,0,1,301,13,6,7,23,205.84615384615384,766,14,206,95,,,
0,37,0,7,0,1,299,18,9,9,4,224.05555555555554,588,14,200,99,1.0,352.0,352.0
0,32,1,2,0,2,298,17,10,7,4,155.7058823529412,740,10,202,96,1.0,183.0,183.0
0,28,1,8,2,0,297,17,11,6,19,766.2352941176471,10661,15,195,102,1.0,190.0,190.0
0,27,0,3,1,3,295,15,11,4,20,131.6,426,1,203,92,,,
0,32,1,2,1,1,295,17,6,11,4,522.7647058823529,6621,3,194,101,,,
0,33,0,7,2,0,294,21,9,12,6,709.8571428571429,11615,39,201,93,2.0,181.0,260.0
0,34,0,8,1,0,294,13,7,6,2,201.15384615384616,458,21,191,103,,,
1,28,1,5,0,3,294,9,4,5,40,179.0,409,3,185,109,1.0,44.0,44.0
0,37,1,7,1,3,293,9,4,5,17,140.22222222222223,394,16,152,141,,,
0,40,1,2,1,0,293,15,8,7,3,148.33333333333334,334,27,183,110,1.0,135.0,135.0
0,34,0,7,0,1,292,14,11,3,20,107.71428571428571,355,2,198,94,,,
0,30,1,7,1,2,291,15,4,11,3,201.2,430,42,205,86,,,
0,37,0,4,1,0,291,14,4,10,82,262.35714285714283,550,31,200,91,,,
0,27,1,2,2,1,290,17,8,9,7,181.8235294117647,626,1,205,85,,,
0,32,1,4,0,0,289,18,10,8,1,140.0,565,10,178,111,,,
0,36,1,5,0,1,289,16,5,11,2,143.4375,402,19,205,84,,,
0,37,1,5,0,1,288,15,10,5,14,158.26666666666668,377,11,186,102,,,
0,28,0,2,0,1,288,13,10,3,28,195.30769230769232,383,40,207,81,,,
1,42,1,2,1,2,288,6,3,3,39,199.83333333333334,405,9,185,103,,,
1,30,1,3,0,3,288,11,6,5,5,215.9090909090909,844,7,201,87,2.0,34.0,153.0
0,34,1,7,2,0,286,21,11,10,16,191.71428571428572,381,9,192,94,,,
0,38,1,7,3,0,286,16,9,7,3,1110.375,14636,32,202,84,,,
0,25,1,3,4,0,286,24,11,13,16,188.16666666666666,681,9,198,88,,,
0,36,0,2,1,0,285,13,7,6,11,168.46153846153845,455,27,202,83,,,
0,40,1,7,3,1,283,16,7,9,3,156.4375,476,29,207,76,,,
0,43,0,3,1,1,283,14,8,6,29,935.9285714285714,10599,32,150,133,,,
0,40,1,9,1,0,282,13,8,5,33,216.15384615384616,527,11,204,78,1.0,108.0,108.0
0,38,1,3,3,0,282,14,9,5,19,142.42857142857142,355,9,151,131,,,
0,38,0,3,1,0,280,16,8,8,4,163.75,539,4,208,72,,,
0,43,0,7,1,0,280,20,9,11,5,133.35,487,11,192,88,,,
0,46,1,9,0,0,279,11,6,5,56,218.1818181818182,566,19,209,70,,,
0,28,0,3,2,0,278,15,7,8,36,182.6,541,22,207,71,,,
0,41,0,5,1,0,277,13,7,6,10,141.30769230769232,338,6,208,69,,,
0,41,0,2,1,0,277,24,18,6,25,182.70833333333334,559,3,196,81,,,
0,30,0,3,4,0,276,16,7,9,16,211.0,539,1,206,70,,,
0,38,1,3,0,1,274,21,11,10,4,156.1904761904762,455,19,205,69,1.0,4.0,4.0
0,36,0,2,0,1,273,21,8,13,46,681.952380952381,10918,22,204,69,1.0,111.0,111.0
0,38,1,2,2,0,270,12,5,7,76,205.25,357,21,197,73,,,
0,35,0,2,1,0,270,17,10,7,1,109.0,269,43,180,90,,,
0,37,1,2,1,0,269,8,8,0,4,124.375,268,32,167,102,,,
0,30,0,6,1,1,267,13,7,6,10,172.23076923076923,423,2,197,70,,,
1,38,1,1,1,2,267,7,3,4,19,144.71428571428572,534,34,150,117,1.0,318.0,318.0
1,37,1,3,1,2,265,8,4,4,37,295.75,918,16,204,61,2.0,59.0,319.0
0,39,1,2,3,1,263,7,6,1,6,157.71428571428572,542,12,205,58,,,
0,39,0,8,0,0,262,26,11,15,10,166.69230769230768,440,4,208,54,,,
0,34,0,2,0,1,262,12,3,9,10,158.66666666666666,497,4,198,64,,,
0,24,0,9,0,0,261,15,7,8,5,102.0,366,17,201,60,,,
0,37,1,6,1,0,260,11,7,4,6,159.1818181818182,369,5,204,56,,,
0,31,0,2,3,0,260,15,6,9,43,206.26666666666668,449,2,199,61,,,
1,35,1,1,1,2,259,11,5,6,43,265.45454545454544,881,31,203,56,1.0,38.0,38.0
0,31,1,2,0,1,258,19,10,9,13,141.1578947368421,616,6,206,52,,,
0,39,1,7,2,0,255,14,8,6,6,169.42857142857142,619,10,193,62,,,
0,34,0,7,3,2,250,13,9,4,40,256.7692307692308,599,23,196,54,,,
0,31,0,7,1,0,250,13,7,6,7,112.92307692307692,467,11,194,56,,,
0,37,0,7,1,0,248,9,9,0,63,171.0,320,7,205,43,,,
0,42,1,3,2,1,247,14,10,4,2,1906.7142857142858,12345,18,175,72,,,
0,36,0,2,0,1,246,23,15,8,6,203.56521739130434,1402,14,208,38,,,
0,26,1,6,2,0,245,16,5,11,15,154.875,413,11,208,37,1.0,45.0,45.0
0,34,1,3,0,1,245,7,6,1,19,230.28571428571428,505,6,188,57,,,
0,41,0,7,1,0,245,16,8,8,7,820.625,10554,8,183,62,,,
0,25,1,8,0,1,243,16,5,11,12,169.3125,598,11,202,41,1.0,164.0,164.0
0,32,1,8,4,1,243,18,10,8,2,229.38888888888889,619,39,207,36,2.0,134.0,169.0
0,40,0,7,0,1,243,11,5,6,9,221.54545454545453,640,17,153,90,,,
0,36,1,6,1,0,242,12,7,5,2,900.0833333333334,9296,17,159,83,,,
0,38,1,2,2,1,241,14,7,7,2,160.64285714285714,429,11,201,40,,,
1,31,1,7,0,3,241,8,2,6,37,295.75,879,15,204,37,2.0,96.0,260.0
0,31,0,8,1,0,239,15,7,8,21,188.26666666666668,439,39,175,64,1.0,203.0,203.0
0,39,1,5,3,1,239,13,10,3,9,145.15384615384616,401,2,194,45,,,
0,28,1,1,3,0,239,15,10,5,8,174.4,384,9,209,30,,,
0,39,0,2,0,1,236,15,7,8,2,117.46666666666667,324,1,207,29,,,
0,26,0,8,0,1,234,10,3,7,18,102.5,308,5,171,63,,,
1,37,1,2,1,2,234,10,5,5,32,214.1,581,22,184,50,1.0,5.0,5.0
0,34,0,2,1,2,234,19,10,9,14,163.68421052631578,505,4,183,51,,,
0,32,0,4,4,1,234,17,5,12,20,184.8235294117647,447,67,187,47,,,
0,27,1,2,0,1,233,14,10,4,6,191.07142857142858,509,23,205,28,,,
0,31,0,7,1,0,233,22,13,9,14,167.86363636363637,577,20,201,32,,,
0,39,1,2,1,0,232,12,4,8,21,172.83333333333334,556,3,186,46,1.0,8.0,8.0
1,38,0,2,2,0,230,7,4,3,8,157.57142857142858,285,17,203,27,1.0,31.0,31.0
0,41,0,2,4,2,230,16,3,13,3,1082.875,14984,5,197,33,,,
0,38,0,6,0,1,230,22,10,12,5,149.4090909090909,511,6,202,28,,,
0,40,0,2,0,1,229,14,6,8,3,165.85714285714286,400,6,206,23,,,
0,37,0,2,0,1,229,13,6,7,18,214.92307692307693,589,10,199,30,,,
0,30,0,7,2,0,226,10,3,7,48,208.8,441,14,200,26,,,
0,41,0,6,1,0,226,22,11,11,7,152.3181818181818,492,45,204,22,,,
0,30,0,1,1,0,226,12,5,7,17,194.16666666666666,394,22,198,28,,,
1,31,1,8,0,3,224,8,5,3,10,122.375,250,21,153,71,1.0,49.0,49.0
0,35,0,8,1,1,220,18,10,8,9,119.5,562,24,182,38,1.0,126.0,126.0
1,36,1,2,0,2,219,8,6,2,112,327.375,877,8,193,26,1.0,16.0,16.0
0,37,1,8,3,2,218,11,8,3,110,256.72727272727275,484,39,203,15,,,
0,41,1,7,3,1,218,11,7,4,53,163.9090909090909,461,35,170,48,,,
0,37,1,2,0,1,217,14,6,8,11,186.21428571428572,469,16,193,24,,,
1,34,1,1,3,1,217,8,6,2,9,251.75,789,27,195,22,1.0,35.0,35.0
0,37,0,7,1,0,216,12,8,4,7,124.75,284,7,192,24,,,
0,37,1,3,1,0,215,13,9,4,46,189.30769230769232,490,8,196,19,,,
0,38,0,7,0,0,215,10,7,3,31,277.1,635,10,207,8,,,
0,39,1,7,0,3,214,11,8,3,28,151.9090909090909,511,3,165,49,,,
0,31,0,5,4,1,213,16,8,8,9,178.0625,618,49,209,4,,,
0,32,0,1,1,0,213,17,8,9,4,136.11764705882354,464,15,207,6,,,
0,32,1,3,1,0,212,14,6,8,5,133.85714285714286,398,5,209,3,,,
0,30,1,6,1,0,210,17,6,11,24,184.76470588235293,366,9,190,20,,,
1,38,1,7,0,2,210,11,7,4,5,222.72727272727272,824,1,196,14,2.0,137.0,233.0
0,32,1,3,2,0,210,10,5,5,46,221.0,582,3,114,96,1.0,14.0,14.0
0,40,0,3,1,0,209,10,5,5,22,103.6,375,10,204,5,,,
0,42,0,7,1,0,206,24,12,12,8,186.54166666666666,465,14,195,11,1.0,35.0,35.0
0,38,0,6,3,0,205,13,7,6,1,187.0,479,1,180,25,,,
0,33,0,1,1,2,205,13,4,9,3,143.46153846153845,396,17,207,-2,,,
0,42,0,3,2,1,205,15,5,10,1,187.8,585,4,208,-3,,,
0,32,0,7,4,1,204,14,10,4,86,512.8571428571429,3625,2,202,2,,,
0,38,0,2,2,1,201,16,4,12,18,566.6875,6330,14,208,-7,,,
1,36,1,7,4,0,201,9,5,4,22,262.55555555555554,905,12,204,-3,1.0,199.0,199.0
1,27,1,6,0,3,201,9,5,4,33,235.66666666666666,751,13,179,22,2.0,9.0,41.0
0,35,1,7,4,1,200,16,9,7,15,116.0,389,1,200,0,,,
0,34,0,7,1,0,200,18,9,9,11,195.83333333333334,618,30,205,-5,2.0,109.0,263.0
0,34,1,7,0,2,199,20,11,9,19,142.45,657,2,190,9,,,
0,30,1,1,0,0,198,7,3,4,20,129.42857142857142,309,40,176,22,,,
0,44,1,3,1,0,197,13,7,6,2,154.3846153846154,446,4,196,1,,,
0,35,1,8,0,2,196,16,11,5,15,161.5625,527,14,204,-8,,,
0,28,1,3,4,1,196,23,10,13,18,169.56521739130434,572,22,205,-9,1.0,71.0,71.0
0,30,0,7,1,0,195,18,6,12,27,933.3888888888889,13901,12,207,-12,,,
0,38,1,2,4,3,193,11,6,5,5,170.63636363636363,337,2,150,43,,,
0,33,1,7,1,3,192,16,12,4,2,118.3125,576,26,207,-15,,,
0,38,0,3,1,2,191,10,5,5,27,145.3,260,7,199,-8,1.0,81.0,81.0
0,38,0,2,0,1,191,20,11,9,17,168.85,411,6,208,-17,,,
0,47,0,2,3,0,191,17,8,9,13,193.0,634,37,195,-4,,,
0,39,0,6,1,0,191,16,12,4,11,683.5625,8460,10,208,-17,1.0,265.0,265.0
0,38,0,3,0,1,190,15,7,8,6,132.8,426,6,208,-18,1.0,50.0,50.0
0,40,0,1,1,0,190,9,5,4,56,999.3333333333334,7324,29,208,-18,,,
0,34,1,9,2,0,189,16,8,8,14,155.5625,520,25,206,-17,1.0,193.0,193.0
0,31,0,6,1,1,187,14,7,7,12,98.57142857142857,250,2,181,6,,,
0,33,0,5,0,0,187,17,8,9,3,133.35294117647058,397,12,205,-18,,,
0,29,1,1,3,0,185,18,12,6,10,146.66666666666666,494,8,183,2,1.0,196.0,196.0
0,39,1,6,2,0,185,22,13,9,7,87.31818181818181,363,14,208,-23,,,
0,39,0,2,1,1,184,16,5,11,17,142.6875,530,6,203,-19,2.0,101.0,168.0
0,40,1,3,2,1,183,14,10,4,27,201.64285714285714,697,3,187,-4,,,
0,37,0,7,3,1,183,6,5,1,4,203.16666666666666,469,2,206,-23,,,
1,34,1,8,0,3,182,10,5,5,16,261.8,775,15,204,-22,,,
1,26,1,1,1,2,180,11,6,5,28,225.8181818181818,868,9,163,17,1.0,46.0,46.0
0,28,1,7,1,0,180,21,6,15,4,108.14285714285714,240,1,166,14,,,
1,35,0,7,2,0,179,8,5,3,6,88.875,253,20,196,-17,1.0,168.0,168.0
0,30,1,7,2,1,179,22,12,10,12,138.0,406,8,198,-19,,,
1,36,1,3,1,2,178,8,5,3,26,288.0,913,24,207,-29,1.0,319.0,319.0
0,35,1,7,0,1,176,16,6,10,27,180.25,578,16,192,-16,,,
1,29,1,2,0,3,176,8,2,6,16,323.125,881,2,200,-24,1.0,35.0,35.0
0,32,0,7,0,1,174,15,7,8,2,150.66666666666666,337,9,209,-35,,,
0,36,1,3,0,1,174,14,6,8,7,181.21428571428572,710,13,189,-15,1.0,99.0,99.0
0,35,0,7,1,1,173,8,8,0,19,111.375,239,27,179,-6,,,
0,30,0,7,0,1,172,18,9,9,1,108.66666666666667,271,10,209,-37,,,
1,36,1,7,1,2,172,8,5,3,24,293.125,892,22,205,-33,1.0,27.0,27.0
1,21,1,4,4,0,172,10,4,6,61,202.1,360,27,165,7,,,
0,41,1,2,2,3,170,17,10,7,1,197.94117647058823,567,11,190,-20,,,
0,38,0,8,0,0,170,10,5,5,28,199.3,698,15,193,-23,,,
0,37,1,2,0,2,169,11,6,5,15,257.1818181818182,736,13,162,7,,,
0,40,0,7,3,1,165,15,10,5,32,171.0,355,11,206,-41,,,
1,38,1,1,0,3,164,8,3,5,22,355.125,914,41,198,-34,3.0,129.0,260.0
1,36,1,3,0,3,162,11,6,5,6,164.54545454545453,789,2,171,-9,,,
1,36,1,3,1,2,161,8,3,5,48,292.625,863,15,175,-14,,,
0,33,1,8,1,0,160,17,7,10,5,153.58823529411765,571,12,204,-44,,,
1,40,1,2,1,2,160,9,6,3,6,147.11111111111111,433,21,199,-39,1.0,290.0,290.0
0,28,1,7,1,0,159,14,7,7,21,244.28571428571428,589,2,194,-35,,,
0,32,1,1,0,3,159,10,4,6,10,144.9,506,32,187,-28,,,
0,38,0,7,0,1,159,17,10,7,1,185.35294117647058,560,5,202,-43,,,
0,37,0,8,0,1,157,18,7,11,2,152.44444444444446,474,6,209,-52,,,
0,23,1,3,0,0,157,16,8,8,7,177.25,422,16,198,-41,,,
0,40,0,1,1,0,156,17,12,5,3,205.7058823529412,496,11,168,-12,,,
0,35,1,8,2,0,156,23,14,9,4,168.7826086956522,508,5,192,-36,,,
0,27,0,7,4,1,156,14,5,9,17,191.57142857142858,398,7,196,-40,,,
0,38,1,2,1,0,156,15,9,6,38,253.33333333333334,451,3,204,-48,1.0,186.0,186.0
0,39,0,3,1,0,155,11,6,5,2,133.36363636363637,248,10,199,-44,,,
0,44,1,2,0,1,154,20,8,12,3,182.1,504,29,167,-13,,,
0,34,0,7,2,0,153,18,8,10,10,176.77777777777777,734,3,203,-50,,,
0,40,0,1,0,1,153,11,6,5,53,151.8181818181818,358,4,160,-7,,,
0,32,1,7,2,0,153,18,12,6,13,171.72222222222223,536,23,207,-54,,,
0,34,0,3,3,2,152,16,9,7,7,162.8125,437,34,202,-50,,,
0,38,1,1,1,1,149,15,10,5,4,192.8,662,21,206,-57,,,
0,23,1,1,3,0,146,13,6,7,3,141.3846153846154,384,17,184,-38,,,
0,40,1,5,0,1,146,13,3,10,72,163.76923076923077,296,5,179,-33,,,
1,36,0,3,2,0,144,9,4,5,4,119.22222222222223,317,1,205,-61,1.0,169.0,169.0
0,34,1,5,1,0,143,15,6,9,15,198.66666666666666,437,58,206,-63,,,
0,27,1,1,1,0,140,17,6,11,16,153.2941176470588,374,35,205,-65,,,
0,28,1,7,1,2,140,22,14,8,6,796.2272727272727,14155,13,190,-50,,,
0,45,0,2,4,0,139,17,8,9,4,155.23529411764707,487,11,204,-65,,,
1,37,1,7,1,1,138,11,4,7,12,224.9090909090909,910,6,117,21,1.0,198.0,198.0
0,33,0,3,0,1,135,10,5,5,2,127.2,228,57,206,-71,,,
0,30,1,2,0,1,135,19,10,9,3,854.2631578947369,13007,3,189,-54,,,
0,42,1,7,0,1,135,20,10,10,9,189.1,621,13,196,-61,1.0,132.0,132.0
0,39,1,2,0,1,133,19,6,13,9,97.42105263157895,326,26,208,-75,,,
0,40,1,2,3,0,132,16,4,12,11,135.5625,398,14,197,-65,1.0,94.0,94.0
0,43,1,1,1,0,130,17,10,7,51,153.64705882352942,591,1,187,-57,,,
1,33,1,5,0,3,129,11,6,5,37,232.1818181818182,790,5,171,-42,1.0,137.0,137.0
0,36,1,2,1,1,128,15,8,7,22,185.86666666666667,417,22,204,-76,,,
0,38,0,2,0,1,128,18,8,10,3,173.94444444444446,651,4,209,-81,,,
0,40,1,1,2,1,126,14,7,7,4,98.28571428571429,342,7,194,-68,,,
0,44,1,3,0,1,125,17,9,8,16,163.05882352941177,719,6,186,-61,,,
0,40,0,2,4,0,125,18,11,7,60,183.38888888888889,326,3,204,-79,,,
1,33,1,6,1,2,125,8,3,5,2,296.0,837,17,187,-62,1.0,230.0,230.0
0,31,0,4,2,0,125,11,5,6,38,175.0,363,44,199,-74,,,
0,38,0,5,0,1,123,21,9,12,3,214.71428571428572,643,7,202,-79,,,
0,32,0,7,3,1,123,15,10,5,15,218.8,647,18,186,-63,1.0,157.0,157.0
1,30,1,1,0,3,123,8,3,5,30,205.5,733,2,187,-64,1.0,12.0,12.0
0,43,1,7,1,0,122,21,10,11,5,196.85714285714286,431,1,206,-84,,,
0,35,1,7,4,1,122,14,6,8,9,1217.7857142857142,14838,11,206,-84,,,
0,44,1,7,4,1,121,13,7,6,5,126.92307692307692,316,13,200,-79,,,
0,35,1,6,3,1,121,22,9,13,4,125.18181818181819,320,2,207,-86,,,
0,31,0,7,0,1,119,14,11,3,3,144.71428571428572,524,25,207,-88,,,
0,43,0,3,2,0,117,18,12,6,6,201.16666666666666,632,19,149,-32,,,
0,35,0,2,1,0,116,7,1,6,20,141.0,324,7,206,-90,,,
0,33,1,3,0,1,114,10,3,7,8,120.2,258,4,203,-89,,,
0,26,0,1,1,0,114,10,7,3,9,171.8,757,50,204,-90,,,
0,35,0,2,0,1,113,14,8,6,29,218.07142857142858,430,2,198,-85,,,
0,48,1,8,0,1,112,15,5,10,12,100.53333333333333,288,5,198,-86,,,
0,32,0,5,0,1,110,10,5,5,31,202.4,539,7,202,-92,,,
0,37,1,2,2,0,109,15,8,7,6,178.93333333333334,688,5,187,-78,,,
0,39,1,5,2,1,109,19,10,9,16,201.42105263157896,2124,5,200,-91,1.0,229.0,229.0
0,38,0,3,0,1,108,16,8,8,19,123.0,474,9,205,-97,,,
0,38,1,4,4,1,107,13,7,6,7,145.84615384615384,330,8,172,-65,,,
1,27,0,4,2,0,107,8,4,4,15,266.125,929,3,195,-88,,,
1,43,1,6,1,2,107,11,5,6,12,212.0,872,1,194,-87,1.0,15.0,15.0
0,50,1,7,0,1,106,16,8,8,4,134.4375,346,51,207,-101,,,
1,33,1,7,1,2,103,10,4,6,11,274.3,884,1,135,-32,,,
0,30,1,7,2,0,102,22,14,8,6,167.22727272727272,608,13,205,-103,,,
0,35,0,3,4,0,102,13,7,6,8,127.53846153846153,560,8,184,-82,,,
1,38,1,3,1,2,101,11,5,6,24,103.63636363636364,258,1,194,-93,1.0,5.0,5.0
1,31,0,3,2,0,100,7,4,3,65,275.57142857142856,765,24,206,-106,1.0,32.0,32.0
1,39,1,3,3,1,99,9,4,5,9,90.33333333333333,183,1,203,-104,1.0,168.0,168.0
0,40,1,3,3,1,98,16,9,7,18,217.125,563,16,209,-111,,,
0,44,1,8,2,0,97,20,12,8,10,780.05,12708,2,195,-98,1.0,10.0,10.0
1,27,1,4,0,3,96,10,6,4,16,227.2,855,8,182,-86,1.0,76.0,76.0
0,36,1,6,1,2,95,13,6,7,2,130.3846153846154,414,10,185,-90,,,
0,36,1,2,1,0,94,15,6,9,29,139.46666666666667,358,1,182,-88,,,
0,28,1,1,1,0,88,14,6,8,1,616.9285714285714,6272,18,167,-79,,,
0,34,1,2,2,0,88,11,3,8,26,279.45454545454544,664,42,207,-119,,,
0,37,1,6,1,0,84,21,10,11,8,165.38095238095238,673,5,187,-103,1.0,77.0,77.0
0,34,1,7,0,1,84,5,2,3,226,300.0,405,8,199,-115,,,
0,32,1,5,0,1,84,13,7,6,3,128.30769230769232,340,8,193,-109,,,
0,32,0,6,2,2,83,12,1,11,9,132.0,369,19,171,-88,,,
0,27,1,4,0,1,79,9,6,3,14,1409.5555555555557,11426,60,206,-127,,,
0,39,1,8,0,0,78,17,7,10,21,175.58823529411765,587,21,199,-121,,,
0,36,0,8,1,0,77,14,10,4,20,179.78571428571428,333,9,191,-114,,,
0,45,1,3,2,0,76,10,8,2,36,163.4,341,1,163,-87,,,
0,40,0,7,2,1,76,22,14,8,5,177.86363636363637,553,14,199,-123,,,
0,47,1,7,0,1,74,15,10,5,6,163.33333333333334,522,5,208,-134,,,
0,35,0,2,1,1,73,10,4,6,16,104.4,456,4,169,-96,,,
0,40,1,3,1,0,73,15,6,9,11,195.26666666666668,501,28,207,-134,,,
0,36,1,6,0,0,72,18,9,9,7,193.27777777777777,584,3,208,-136,,,
0,39,0,8,1,0,72,21,9,12,4,186.52380952380952,492,18,205,-133,,,
0,31,0,2,0,1,72,10,5,5,5,1025.3,9685,31,164,-92,1.0,92.0,92.0
0,31,1,7,1,0,67,19,7,12,18,152.6315789473684,456,3,209,-142,,,
0,37,0,7,1,0,65,15,11,4,11,208.93333333333334,472,6,193,-128,1.0,229.0,229.0
0,37,0,2,0,0,64,11,5,6,17,168.27272727272728,448,2,180,-116,,,
0,35,1,2,0,1,60,15,6,9,16,198.73333333333332,512,24,190,-130,,,
0,32,0,3,1,0,58,18,8,10,1,871.2222222222222,12482,18,207,-149,,,
